Aa	Hubertus Antonius van der Aa 
A.A.Cocucci	Andrea A. Cocucci 
A.A.Eaton	Alvah Augustus Eaton 
A.A.Fisch.Waldh.	Alexandr Alexandrovich Fischer von Waldheim 
A.A.Hend.	Andrew Augustus Henderson 
A.Ames	Adeline Ames 
A.Anderson	Alexander Anderson 
Aarons.	Aaron Aaronsohn 
A.Barbero	Andrés Barbero 
A.Bassi	Agostino Bassi 
Abbayes	Henry Nicollon des Abbayes 
Abbot	John Abbot 
Abedin	Sultanul Abedin 
Aberconway	Henry McLaren, 2nd Baron Aberconway 
A.Berger	Alwin Berger 
A.B.Frank	Albert Bernhard Frank 
A.B.Graf	Alfred Byrd Graf 
A.B.Jacks.	Albert Bruce Jackson 
A.Bloxam	Andrew Bloxam 
A.Blytt	Axel Gudbrand Blytt 
A.Br.	Addison Brown 
A.Braun	Alexander Karl Heinrich Braun 
Abramov	Ivan N. Abramov 
Abrom.	Johannes Abromeit 
A.Bruggen	Adolph Cornelis van Bruggen 
A.Butler	Alan Butler 
A.Cabrera	Ángel Cabrera 
A.Camus	Aimée Antoinette Camus 
A.Cast.	Alberto Castellanos 
Acerbi	Giuseppe Acerbi 
Ach.	Erik Acharius 
A.C.H.Blinks	Anne Catherine Hof Blinks 
A.Chev.	Auguste Jean Baptiste Chevalier 
Achv.	Agazi Asaturovich Achverdov 
Acloque	Alexandre Noël Charles Acloque 
A.C.Schultz	August Christian Schultz 
A.C.Sm.	Albert Charles Smith 
Acuña	Julián Acuña Galé 
A.Cunn.	Allan Cunningham 
A.C.White	Alain Campbell White 
Adams	Johann Friedrich Adam 
Adans.	Michel Adanson 
A.DC.	Alphonse Louis Pierre Pyrame de Candolle 
A.D.Danilov	Alexander Danilovich Danilov 
Ade	Alfred Ade 
Adelb.	Albert George Ludwig Adelbert 
Adema	Fredericus Arnoldus Constantin Basil Adema 
Aderh.	Rudolf Ferdinand Theodor Aderhold 
A.D.Hardy	Alfred Douglas Hardy 
A.D.Hawkes	Alex Drum Hawkes 
A.Dietr.	Albert Gottfried Dietrich 
Adolf	Nina Avgustinovna Adolf 
A.E.D.Daniels	Albert Ebenezer Dulip Daniels 
A.E.Hoffm	Adriana Hoffmann 
Aellen	Paul Aellen 
A.E.Reuss	August Emanuel Rudolph von Reuss 
A.Evans	Alexander William Evans 
A.E.van Wyk	Abraham Erasmus Braam van Wyk 
A.F.Bartsch	Alfred Frank Bartsch 
A.Fedtsch.	Alexei Pavlovich Fedchenko 
A.Fisch.	Alfred Fischer 
Afonina	Olga Mikhailovna Afonina 
A.F.Tryon	Alice Faber Tryon 
Afzel.	Adam Afzelius 
Agerer	Reinhard Agerer 
A.G.Floyd	Alexander G. Floyd 
A.Gibson	Alexander Gibson 
A.G.Jones	Almut Gitter Jones 
A.G.Lyon	Alexander Geoffrey Lyon 
A.G.Mill.	Anthony G. Miller 
A.Gray	Asa Gray 
A.Ham.	Arthur Hamilton 
A.Hässl.	Arne Hässler 
A.Hay	Alistair Hay 
A.Heller	Amos Arthur Heller 
A.Hend.	Archibald Henderson 
A.Henry	Augustine Henry 
A.H.Evans	Arthur Humble Evans 
A.H.Gentry	Alwyn Howard Gentry 
A.H.Heller	Alfonse Henry Heller 
A.H.Holmgren	Arthur Hermann Holmgren 
Ahmadjian	Vernon Ahmadjian 
Ahrendt	Leslie Walter Allen Ahrendt 
A.H.S.Lucas	Arthur Henry Shakespeare Lucas 
A.Huet	Alfred Huet du Pavillon 
Ainsw.	Geoffrey Clough Ainsworth 
Airy Shaw	Herbert Kenneth Airy Shaw 
Aitch.	James Edward Tierney Aitchison 
Aiton	William Aiton 
A.Jaeger	August Jaeger 
A.J.Eames	Arthur Johnson Eames 
A.J.Hend.	Andrew Henderson 
A.J.Hill	Albert Joseph Hill 
A.J.M.Baker	Alan John Martin Baker 
A.J.Paton	Alan James Paton 
A.J.Scott	Andrew John Scott 
A.Juss.	Adrien-Henri de Jussieu 
A.Kern.	Anton Kerner von Marilaun 
Akhani	Hossein Akhani 
A.K.Irvine	Anthony Kyle Irvine 
A.K.Skvortsov	Alexey Skvortsov 
A.K.S.Prasad	Akshinthala K. Sai Krishna Prasad 
A.Kurz	Albert Kurz 
A.K.Wallace	Anne Karin Wallace 
Alain	Henri Alain Liogier 
A.L.Andrews	Albert LeRoy Andrews 
Alb.	Johannes Baptista von Albertini 
Al.Brongn.	Alexandre Brongniart 
Aldrovandi	Ulisse Aldrovandi 
Alderw.	Cornelis Rugier Willem Karel van Alderwerelt van Rosenburgh 
Alexeeva.	N. B. Alexeeva
Alef.	Friedrich Georg Christoph Alefeld 
A.Lem.	Adrien Lemaire 
A.Lesson	Adolphe Pierre Primevère Lesson 
Alexander	Edward Johnston Alexander 
Al.Jahn	Alfredo Jahn Hartman 
All.	Carlo Allioni 
A.L.Lamb	Anthony L. Lamb 
Allemão	Francisco Freire Allemão e Cysneiro 
Allred	Kelly Allred 
Alm	Carl Gustav Alm 
Á.Löve	Áskell Löve 
Alphand	Jean-Charles Alphand 
Alph.Wood	Alphonso Wood 
Alpino	Prospero Alpino 
Al-Shehbaz	Ihsan Ali Al-Shehbaz 
A.L.Sm.	Annie Lorrain Smith 
Alston	Arthur Hugh Garfit Alston 
Alstr.	Clas Alströmer 
Altam.	Fernando Altamirano 
Altschul	Siri von Reis 
A.Macedo	Amaro Macedo 
Amakawa	Tairoko Amakawa 
Amann	Johann Amann 
Amaral	Ayrton Amaral 
A.Massal.	Abramo Bartolommeo Massalongo 
A.Mathews	Andrew Mathews 
Amberg	Otto Amberg 
Ambronn	Hermann Ambronn 
Ambrosetti	José Arturo Ambrosetti 
Ambrosi	Francesco Ambrosi 
Ambroz	Josef Ambroz 
A.Meeuse	Adrianus Dirk Jacob Meeuse 
Ameljcz.	V. P. Ameljczenko 
Ames	Oakes Ames 
Amich	Francisco Amich García 
Amici	Giovanni Battista Amici 
Amin	Amal Amin 
Amirkh.	Amirkhan Magomedovich Amirkhanov 
Amman	Johann Amman 
Ammann	Morgane Ammann 
Ammerman	Elizabeth Ammerman 
Ammirati	Joseph F. Ammirati 
Amo	Mariano del Amo y Mora 
Amor	Angel Amor Morales 
A.M.Ross	Alexander Milton Ross 
Amshoff	Gerda Jane Hillegonda Amshoff 
Amsler	Charles D. Amsler 
A.M.Sm.	Annie Morrill Smith 
A.Murray	Andrew Dickson Murray 
A.N.Danilov	Afanasij Nikolaevich Danilov 
A.N.Demidov	Anatoly Nikolaievich Demidov, 1st Prince of San Donato 
Andersen	Johannes Carl Andersen 
Anderson	James Anderson 
Andersson	Nils Johan Andersson 
Andr.	Gábor Andreánszky 
André	Édouard André 
Andres	Heinrich Andres 
Andrews	Henry Charles Andrews 
Andronov	Nikolaĭ Matveevich Andronov 
Andrz.	Antoni Lukianowicz Andrzejowski 
A.Nelson	Aven Nelson 
A.Neumann	Alfred Neumann 
Ångstr.	Johan Ångström 
Ant.Juss.	Antoine de Jussieu 
Ant.Molina	José Antonio Molina Rosito 
Antoine	Franz Antoine 
Ant.Schott	Anton Schott 
A.Pearson	Arthur Anselm Pearson 
A.Phelps	Almira Hart Lincoln Phelps 
Applegate	Elmer Ivan Applegate 
A.Pramanik	Arabinda Pramanik 
Apstein	Carl Heinrich Apstein 
A.Raynal	Aline Marie Raynal 
Arcang.	Giovanni Arcangeli 
Archer	Thomas Croxen Archer 
A.R.Clapham	Arthur Roy Clapham 
Ard.	Pietro Arduino 
Arechav.	José Arechavaleta 
A.Regel	Johann Albert von Regel 
Arènes	Jean Arènes 
Aresch.	Johan Erhard Areschoug 
Argent	Graham Charles George Argent 
A.Rich.	Achille Richard 
Arm.	Edward Armitage 
Arn.	George Arnott Walker Arnott 
Arnell	Hampus Wilhelm Arnell 
Arnold	Ferdinand Christian Gustav Arnold 
A.Robyns	Andre Georges Marie Walter Albert Robyns 
Arráb.	Francisco Antonio de Arrábida 
Arruda	Manuel Arruda da Câmara 
A.R.Sm.	Alan Reid Smith 
Arthur	Joseph Charles Arthur 
Art.Mey.	Arthur Meyer 
Arv.-Touv.	Casimir Arvet-Touvet 
Asch.	Paul Friedrich August Ascherson 
A.Schatz	Albert Israel Schatz 
A.Schenk	Alexander Schenk 
A.Schimp.	Andreas Franz Wilhelm Schimper 
A.Schlag.	Adolf Schlagintweit 
A.Schlick.	August Schlickum 
A.Schneid.	Albert Schneider 
A.Schnyd.	Albert Schnyder 
A.Schott	Arthur Carl Victor Schott 
A.Schultz	Arthur Schultz 
A.S.George	Alex George 
Ashby	Edwin Ashby 
Ashe	William Willard Ashe 
A.Sinclair	Andrew Sinclair 
Askerova	Rosa K. Askerova 
Asmussen	Conny Asmussen 
A.Soriano	Alberto Soriano 
A.S.Rob.	Alastair Robinson 
Assem	J. van den Assem 
A.Stahl	Agustín Stahl 
A.St.-Hil.	Augustin Saint-Hilaire 
A.Terracc.	Achille Terracciano 
A.Thouars	Abel Aubert Dupetit Thouars 
Atk.	William Sackston Atkinson 
Aubl.	Jean Baptiste Christophore Fusée Aublet 
Aubrév.	André Aubréville 
Aubriet	Claude Aubriet 
Aucher	Pierre Martin Rémi Aucher-Éloy 
Audib.	Urbain Audibert 
Audubon	John James Audubon 
Aug.DC.	Richard Émile Augustin de Candolle 
Ausserd.	Anton Ausserdorfer 
A.Usteri	Alfred Usteri 
Austin	Coe Finch Austin 
A.Vázquez	Antonio Vázquez 
A.V.Bobrov	Alexey Vladimir Bobrov 
A.V.Duthie	Augusta Vera Duthie 
Avé-Lall.	Julius Léopold Eduard Avé-Lallemant 
A.V.Roberts	Andrew Vaughan Roberts 
A.Wall	Arnold Wall 
A.Wallace	Alexander Wallace 
A.W.Benn.	Alfred William Bennett 
A.Weber	Anton Weber 
A.W.Hill	Arthur William Hill 
A.W.Howitt	Alfred William Howitt 
A.Wigg.	Heinrich August Ludwig Wiggers 
A.W.Purdie	Andrew William Purdie 
Axelrod	Daniel I. Axelrod 
Azara	Félix de Azara 
Baas-Beck.	Lourens Gerhard Marinus Baas-Becking 
Bab.	Charles Cardale Babington 
Babc.	Ernest Brown Babcock 
Bach	Michael Bach 
Bachm.	Franz Ewald Theodor Bachmann 
Bacigalupo	Nélida María Bacigalupo 
Bäck	Abraham Bäck 
Backeb.	Curt Backeberg 
Backer	Cornelis Andries Backer 
Backh.	James Backhouse 
Backh.f.	James Backhouse 
Badham	Charles David Badham 
Baehni	Charles Baehni 
Bagn.	James Eustace Bagnall 
Bailey	Jacob Whitman Bailey 
Baill.	Henri Ernest Baillon 
Baillon	Louis Antoine Francois Baillon 
Baines	Henry Baines 
Baker	John Gilbert Baker 
Baker f.	Edmund Gilbert Baker 
Bakh.	Reinier Cornelis Bakhuizen van den Brink 
Bakh.f.	Reinier Cornelis Bakhuizen van den Brink 
Balamuth	William Balamuth 
Balandin	Sergey Aleksandrovich Balandin 
Balansa	Benedict Balansa 
Balb.	Giovanni Battista Balbis 
Baldinger	Ernst Gottfried Baldinger 
Baldwin	William Baldwin 
Balf.	John Hutton Balfour 
Balf.f.	Isaac Bayley Balfour 
Ball	John Ball 
Balls	Edward Kent Balls 
Bals.-Criv.	Giuseppe Gabriel Balsamo-Crivelli 
Bal.-Tul.	Emilie Balátová-Tuláčková 
B.-A.Martin	Bernardin-Antoine Martin 
Banister	John Banister 
Banks	Joseph Banks 
Barbosa	Luis Augusto Grandvaux Barbosa 
Barb.Rodr.	João Barbosa Rodrigues 
Barcelona	Julie F. Barcelona 
Bard.-Vauc.	Martine Bardot-Vaucoulon 
Bargh.	Elso Sterrenberg Barghoorn 
Barham	Henry Barham 
Barker	George Barker 
Barkworth	Mary Elizabeth Barkworth 
Barneby	Rupert Charles Barneby 
Barnhart	John Hendley Barnhart 
Baron	P. Alexis Baron 
Barr	Peter Barr 
Barrande	Joachim Barrande 
Barratt	Joseph Barratt 
Barrel.	Jacques Barrelier 
Barroso	Liberato Joaquim Barroso 
Barrow	Sir John Barrow, 1st Baronet 
Bartal.	Biagio Bartalini 
Bartel	Jim A. Bartel 
Bartell.	Veturia Bartelletti
Barth	József Barth 
Barthlott	Wilhelm Barthlott 
Barthol.	Elam Bartholomew 
Barthol.-Began	Sharon Elaine Bartholomew-Began 
Bartl.	Friedrich Gottlieb Bartling 
Bartlett	Harley Harris Bartlett 
Bartley	Floyd Bartley 
Bartoli	Antonella Bartoli 
Bartolo	Giuseppina Bartolo 
Barton	Benjamin Smith Barton 
Bartram	John Bartram 
Bartsch	Johann Bartsch 
Bas	Cornelis 
Basiner	Theodor Friedrich Julius Basiner 
Bastard	Toussaint Bastard 
Bastian	Henry Charlton Bastian 
Bastow	Richard Austin Bastow 
Batalin	Alexander Theodorowicz Batalin 
Bateman	James Bateman 
Bates	John Mallory Bates 
Batsch	August Johann Georg Karl Batsch 
Batt.	Jules Aimé Battandier 
Baudet	Jean C. Baudet 
Baum	Hugo Baum 
Baumg.	Johann Christian Gottlob Baumgarten 
Baxter	William Baxter 
B.Baumann	Brigitte Baumann 
B.Boivin	Joseph Robert Bernard Boivin 
B.Bremer	Birgitta Bremer 
B.Clément	B. Clément 
B.C.Stone	Benjamin Clemens Stone 
B.D.Greene	Benjamin Daniel Greene 
B.D.Jacks.	Benjamin Daydon Jackson 
Beadle	Chauncey Delos Beadle 
Beal	William James Beal 
Bean	William Jackson Bean 
Beard	John Stanley Beard 
Beardslee	Henry Curtis Beardslee, Jr. 
Beattie	Rolla Kent Beattie 
Beauverie	Jean Beauverie 
Beauvis.	Georges Eugène Charles Beauvisage 
Bebb	Michael Schuck Bebb 
Becc.	Odoardo Beccari 
Bechst.	Johann Matthäus Bechstein 
Beck	Günther Beck von Mannagetta und Lerchenau 
Becker	Johannes Becker 
Bedd.	Richard Henry Beddome 
Bedevian	Armenag K. Bedevian 
Bedn.-Ochyra	Halina Bednarek-Ochyra 
Beechey	Frederick William Beechey 
Beeke	Henry Beeke 
Beentje	Henk Jaap Beentje 
Beetle	Alan Ackerman Beetle 
Bég.	Augusto Béguinot 
Behr	Hans Hermann Behr 
Beissn.	Ludwig Beissner 
Beitel	Joseph M. Beitel 
Bellair	Georges Adolphe Bellair 
Bellardi	Carlo Antonio Lodovico Bellardi 
Bello	Domingo Bello y Espinosa 
Belosersky	Nikola Belosersky 
Beneke	Everett Smith Beneke 
Benj.	Ludwig Benjamin 
Benn.	John Joseph Bennett 
Benner	Walter Mackinett Benner 
Bennert	H. Wilfried Bennert 
Bennet	Sigamony Stephen Richard Bennet 
Bennetts	William James Bennetts 
Benniamin	Asir Benniamin 
Benny	Gerald Leonard Benny 
Benth.	George Bentham 
Bentley	Robert Bentley 
Bentv.	P. A. J. Bentvelzen 
Bentzer	Bengt Bentzer 
Bequaert	Joseph Charles Bequaert 
Bercht.	Friedrich von Berchtold 
Berg	Ernst von Berg 
Berger	Ernst Friedrich Berger 
Bergey	David Hendricks Bergey 
Berggr.	Sven Berggren 
Bergon	Paul Bergon 
Berk.	Miles Joseph Berkeley 
Berkhout	Christine Marie Berkhout 
Bernardi	Luciano Bernardi 
Bernh.	Johann Jacob Bernhardi 
Bernstein	Heinrich Agathon Bernstein 
Berthault	François Berthault 
Berthel.	Sabin Berthelot 
Bertol.	Antonio Bertoloni 
Bertoni	Moisés 
Besch.	Émile Bescherelle 
Besser	Wilibald Swibert Joseph Gottlieb von Besser 
Bessey	Charles Edwin Bessey 
Betche	Daniel Ludwig Ernst Betche 
Bews	John William Bews 
Beyr.	Heinrich Karl Beyrich 
B.F.Dana	Bliss F. Dana 
B.Fedtsch.	Boris Alexjewitsch Fedtschenko 
B.F.Hansen	Bruce Frederick Hansen 
B.F.Holmgren	Björn Frithiofsson Holmgren 
B.Field	Barron Field 
B.G.Bell	Bruce Graham Bell 
B.G.Briggs	Barbara Gillian Briggs 
B.G.Schub.	Bernice Giduz Schubert 
B.H.Allen	Bruce H. Allen 
B.Hansen	Bertel Hansen 
Bhatti	Ghulam Raza Bhatti 
B.H.Buxton	Bertram Henry Buxton 
B.Heyne	Benjamin Heyne 
B.H.Long	Bayard Henry Long 
B.H.Wilcox	Balafama Helen Wilcox 
B.Hyland	Bernard Patrick Matthew Hyland 
Bianca	Giuseppe Bianca 
Bianchi	Giovanni Bianchi 
Bianco	Pasqua Bianco 
Biehler	Johann Friedrich Theodor Biehler 
Bien.	Theophil Joachim Heinrich Bienert 
Bierh.	David William Bierhorst 
Bigelow	Jacob Bigelow 
Billot	Paul Constant Billot 
Binn.	Simon Binnendijk 
Birdw.	George Christopher Molesworth Birdwood 
Bishop	David Bishop 
Bisse	Johannes Bisse 
Bitter	Friedrich August Georg Bitter 
Bittrich	Volker Bittrich 
Biv.	Antonius de Bivoni-Bernardi 
B.J.Jacobsen	Barry J. Jacobsen 
B.Juss.	Bernard de Jussieu 
B.J.Wallace	Benjamin John Wallace 
B.K.Simon	Bryan Kenneth Simon 
Black	Allan A. Black 
Blackw.	Elizabeth Blackwell 
Blake	Joseph Blake 
Blakelock	Ralph Anthony Blakelock 
Blakely	William Blakely 
Blakeslee	Albert Francis Blakeslee 
Blakiston	Thomas Wright Blakiston 
Blanch.	William Henry Blanchard 
Blanco	Francisco Manuel Blanco 
Blandow	Otto Christian Blandow 
Blasdell	Robert Ferris Blasdell 
Blatt.	Ethelbert Blatter 
Blaxell	Donald Frederick Blaxell 
B.L.Clark	Bonnie Lynne Clark 
Blochm.	Friedrich Blochmann 
Bloemb.	Siebe Bloembergen 
Blom	Carl Magnus Blom 
Blomb.	Olof Gotthard Blomberg 
Blomgr.	Nils Harald Blomgren 
Blomq.	Sven Gustaf Krister Gustafson Blomquist 
Blossf.	Robert Blossfeld 
B.L.Rob.	Benjamin Lincoln Robinson 
B.L.Turner	Billie Lee Turner Sr. 
Bluff	Mathias Joseph Bluff 
Blume	Carl Ludwig Blume 
Blytt	Matthias Numsen Blytt 
Błocki	Bronislaw Błocki 
Błoński	Franciszek Kzawery Błoński 
B.M.Allen	Betty Eleanor Gosset Molesworth Allen 
B.Mathew	Brian Frederick Mathew 
B.M.Barthol.	Bruce Monroe Bartholomew 
B.M.Davis	Bradley Moore Davis 
B.Meeuse	Bastiaan Jacob Dirk Meeuse 
B.Nord.	Rune Bertil Nordenstam 
Boccone	Paolo Silvio Boccone 
Böcher	Tyge W. Böcher 
B.O.Dodge	Bernard Ogilvie Dodge 
Boeckeler	Johann Otto Boeckeler 
Boed.	Friedrich Bödeker 
Boehm.	Georg Rudolf Boehmer 
Boehr.	Herman Boerhaave 
Boenn.	Clemens von Bönninghausen 
Boerl.	Jacob Gijsbert Boerlage 
Boiss.	Pierre Edmond Boissier 
Boissev.	Charles Hercules Boissevain 
Boitard	Pierre Boitard 
Boiteau	Pierre Boiteau 
Boivin	Louis Hyacinthe Boivin 
Bojer	Wenceslas Bojer 
Bol.	Henry Nicholas Bolander 
Bo Li	Bo Li 
Bolle	Carl Bolle 
Bolley	Henry Luke Bolley 
Bolton	James Bolton 
Bolus	Harry Bolus 
Bonaf.	Matthieu Bonafous 
Bonap.	Roland Napoléon Bonaparte 
Bondar	Gregório Gregorievich Bondar 
Bong.	August Gustav Heinrich von Bongard 
Bonnier	Gaston Eugène Marie Bonnier 
Bonpl.	Aimé Bonpland 
Boom	Boudewijn Karel Boom 
Boos	Joseph Boos 
Boott	Francis Boott 
Bor	Norman Loftus Bor 
Borbás	Vinczé von Borbás 
Borchs.	Finn Borchsenius 
Boreau	Alexandre Boreau 
Børgesen	Fredrik Christian Emil Børgesen 
Borhidi	Attila Borhidi 
Boriss.	Antonina Georgievna Borissova 
Borkh.	Moritz 
Börner	Carl Julius Bernhard Börner 
Bornm.	Joseph Friedrich Nicolaus Bornmüller 
Borrer	William Borrer 
Borsch	Thomas Borsch 
Borss.Waalk.	Jan van Borssum Waalkes 
Bory	Jean Baptiste Bory de Saint-Vincent 
Borza	Alexandru Borza 
Borzí	Antonino Borzí 
Bos	Jan Just Bos 
Bosc	Louis Augustin Guillaume Bosc 
Bosch	Roelof Benjamin van den Bosch 
Bosser	Jean Marie Bosser 
Botschantz.	Zinaida Botschantzeva 
Botta	Silvia Margarita Botta 
Boucher	Jules Armand Guillaume Boucher de Crèvecœur 
Boud.	Jean Louis Émile Boudier 
Boufford	David Edward Boufford 
Boulay	Jean Nicolas Boulay 
Boulenger	George Albert Boulenger 
Boulger	George Edward Simmonds Boulger 
Boulos	Loutfy Boulos 
Boulter	Michael Charles Boulter 
Bourd.	Thomas Fulton Bourdillon 
Bourdon	M. Bourdon 
Bourdot	Hubert Bourdot 
Bourdu	Robert Bourdu 
Bowles	Edward Augustus Bowles 
Bowman	John Eddowes Bowman the Elder 
Brace	Lewis Jones Knight Brace 
Brach	Anthony Robert Brach 
Brack.	William Dunlop Brackenridge 
Brade	Alexander Curt Brade 
Bradley	Richard Bradley 
Braem	Guido Jozef Braem 
Braggins	John E. Braggins 
Brainerd	Ezra Brainerd 
Braithw.	Robert Braithwaite 
Brako	Lois Brako 
Brand	August Brand 
Brandão	Mitzi Brandão 
Brandbyge	John Brandbyge 
Brandegee	Townshend Stith Brandegee 
Brandenburg	David M. Brandenburg 
Brandis	Dietrich Brandis 
Branner	John Casper Branner 
B.R.Arrill.	Blanca Renée Arrillaga 
Brassard	Guy Raymond Brassard 
Brauer	David F. Brauer 
Braun-Blanq.	Josias Braun-Blanquet 
Brause	Guido Georg Wilhelm Brause 
Bréb.	Louis Alphonse de Brébisson 
Breen	Ruth Olive Schornhurst Breen 
Breistr.	Maurice A. F. Breistroffer 
Bremek.	Cornelis Eliza Bertus Bremekamp 
Brenan	John Patrick Micklethwait Brenan 
Brenckle	Jacob Frederic Brenckle 
Breton	André Breton 
Bretschn.	Emil Bretschneider 
B.Rice	Barry Rice 
Brid.	Samuel Élisée von Bridel 
Bridson	Diane Mary Bridson 
Brieger	Friedrich Gustav Brieger 
Bright	John Bright 
Brign.	Giovanni de Brignoli di Brunnhoff 
Briq.	John Isaac Briquet 
Bristow	Henry William Bristow 
Britten	James Britten 
Brittinger	Christian Casimir Brittinger 
Britton	Nathaniel Lord Britton 
B.R.Keener	Brian Reid Keener 
Bromf.	William Arnold Bromfield 
Bromhead	Edward Ffrench Bromhead 
Brongn.	Adolphe-Théodore Brongniart 
Brooker	Ian Brooker 
Brooks	Cecil Joslin Brooks 
Broome	Christopher Edmund Broome 
Brot.	Félix Avelar Brotero 
Broth.	Viktor Ferdinand Brotherus 
Broughton	Arthur Broughton 
Brouillet	Luc Brouillet 
Brouss.	Pierre Marie Auguste Broussonet 
Browicz	Kazimierz Browicz 
B.R.Ramesh	B. R. Ramesh 
Bruch	Philipp Bruch 
Brücher	Heinz Brücher 
Brug.	Jean Guillaume Bruguière 
Brügger	Christian Georg Brügger 
Brugmans	Sebald Justinus Brugmans 
Bruijn	Ary Johannes De Bruijn 
Brummitt	Richard Kenneth Brummitt 
Brumpt	Émile Josef Alexander Brumpt 
Brunch.	Jørgen Brunchorst 
Brunet	Louis-Ovide Brunet 
Brunfels	Otto Brunfels 
Brunner	Carl Brunner von Wattenwyl 
Brunnth.	Josef Brunnthaler 
Brunsfeld	Steven John Brunsfeld 
Bruyl.	Julia Bruylants 
Bruyns	Peter Vincent Bruyns 
Bryhn	Niels Bryhn 
B.Schenk	Bernhard Schenk 
B.S.Williams	Benjamin Samuel Williams 
Bubák	František Bubák 
Bubani	Pietro Bubani 
Buchanan	John Buchanan 
Buchenau	Franz Georg Philipp Buchenau 
Buch.-Ham.	Francis Buchanan-Hamilton 
Buc'hoz	Pierre Joseph Buc'hoz 
Buckland	William Buckland 
Buckley	Samuel Botsford Buckley 
Buddle	Adam Buddle 
Bui	Ngoc-Sanh Bui 
Bull.	Jean Baptiste François Pierre Bulliard 
Buller	Arthur Henry Reginald Buller 
Bullock	Arthur Allman Bullock 
Bunbury	Charles James Fox Bunbury, 8th Baronet 
Bunge	Alexander Andrejewitsch von Bunge 
Burb.	Frederick William Burbidge 
Burbank	Luther Burbank 
Burch.	William John Burchell 
Burck	William Burck 
Burdet	Hervé Maurice Burdet 
Bureau	Louis Édouard Bureau 
Burges	Norman Alan Burges 
Burgess	Henry W. Burgess 
Burkill	Isaac Henry Burkill 
Burl.	Gertrude Simmons Burlingham 
Burle-Marx	Roberto Burle Marx 
Burm.	Johannes Burman 
Burm.f.	Nicolaas Laurens Burman 
Burnat	Émile Burnat 
Burnett	Gilbert Thomas Burnett 
Burret	Max Burret 
Burrill	Thomas Jonathan Burrill 
Burrows	Elsie May Burrows 
Burtt	Bernard Dearman Burtt 
Bury	Priscilla Susan Bury 
Buscal.	Luigi Buscalioni 
Bush	Benjamin Franklin Bush 
Büttner	Oscar Alexander Richard Büttner 
Buxb.	Franz Buxbaum 
Buxton	Richard Buxton 
Buyss.	Robert du Buysson 
B.Walln.	Bruno Wallnöfer 
B.Whittier	Barbara Whittier
B.W.Phillips	Barry W. Phillips 
B.W.van Ee	Benjamin William van Ee 
B.Y.Geng	Bao-Yin Geng 
Byng	James W. Byng 
C.A.Arnold	Chester Arthur Arnold 
Cabanès	Jean Gustave Cabanès 
C.Abbot	Charles Abbot 
C.Abel	Clarke Abel 
Cabezudo	Baltasar Cabezudo 
Cabrera	Ángel Lulio Cabrera 
C.A.Clark	Carolyn A. Clark 
Caflisch	Jakob Friedrich Caflisch 
C.Agardh	Carl Adolph Agardh 
C.A.Gardner	Charles Austin Gardner 
Cajander	Aimo Cajander 
Calder	James Alexander Calder 
Caley	George Caley 
Calest.	Vittorio Calestani 
Callm.	Martin Wilhelm Callmander 
Calonge	Francisco de Calonge 
Calzada	Juan Ismael Calzada 
Cambage	Richard Hind Cambage 
Cambess.	Jacques Cambessèdes 
C.A.Mey.	Carl Anton von Meyer 
Caminhoá	Joaquim Monteiro Caminhoá 
Camp	Wendell Holmes Camp 
Campacci	Marcos Antonio Campacci 
Campb.	Douglas Houghton Campbell 
Camper	Petrus Camper 
Camus	Giulio 
Canby	William Marriott Canby 
Cannon	John Francis Michael Cannon 
Cantor	Theodore Edward Cantor 
Capuron	René Paul Raymond Capuron 
Carbonó	Eduino Carbonó de la Hoz 
Card.	Jules Cardot 
Cárdenas	Martín Cárdenas 
Cardot	Jules Cardot 
Carey	William Carey 
Carleton	Mark Alfred Carleton 
Carlquist	Sherwin Carlquist 
Carnevali	Germán Carnevali 
Caro	José Aristide Caro 
Carp	Daniel R. Crane 
Carrière	Elie-Abel Carrière 
Carrington	Benjamin Carrington 
Carruth.	William Carruthers 
Caruel	Théodore Caruel 
Carus	Carl Gustav Carus 
Carver	George Washington Carver 
Casar.	Giovanni Casaretto 
C.A.Schenck	Carl Alwin Schenck 
C.A.Sm.	Christo Albertyn Smith 
Casp.	Johann Xaver Robert Caspary 
Casper	Siegfried Jost Casper 
Cass.	Alexandre Henri Gabriel de Cassini 
Castañeda	Marcelino Castañeda y Nuñez de Caceres 
Castelnau	François Louis Nompar de Caumat de Laporte Castelnau 
Cav.	Antonio José Cavanilles 
Cavara	Fridiano Cavara 
C.Bab.	Churchill Babington 
C.Barbosa	César Barbosa 
C.Bauhin	Gaspard Bauhin 
C.B.Beck	Charles B. Beck 
C.B.Clarke	Charles Baron Clarke 
C.B.Rob.	Charles Budd Robinson 
C.C.Berg	Cornelis Christiaan Berg 
C.C.Curtis	Carlton Clarence Curtis 
C.C.Gmel.	Carl Christian Gmelin 
C.Chr.	Carl Frederick Albert Christensen 
C.C.Hu	Chia Chi Hu 
C.Clark	James Curtis Clark 
C.Clarke	Charles M. Clarke 
C.C.Robin	Claude Cesar Robin 
C.C.Tseng	Charles Chiao Tseng 
C.DC.	Anne Casimir Pyrame de Candolle 
C.D.Darl.	Cyril Dean Darlington 
C.De Jong	Cornelis De Jong 
C.D.White	Charles David White 
C.E.A.Winslow	Charles-Edward Amory Winslow 
Ceballos	Luis Ceballos y Fernández de Córdoba 
C.E.Bertrand	Charles Eugène Bertrand 
C.E.Calderón	Cleofé Elsa Calderón 
C.E.C.Fisch.	Cecil Ernest Claude Fischer 
C.E.Cramer	Carl Eduard Cramer 
C.E.Cumm.	Carlos Emmons Cummings 
C.E.Hubb.	Charles Edward Hubbard 
Čelak.	Ladislav Josef Čelakovský 
C.Elliott	Charlotte Elliott 
Celsius	Olof Celsius 
C.E.O.Jensen	Christian Erasmus Otterstrøm 
C.E.Parkinson	Charles Edward Parkinson 
Cerv.	Vicente de Cervantes 
Ces.	Vincenzo de Cesati 
Cesalpino	Andrea Cesalpino 
C.F.Baker	Charles Fuller Baker 
C.F.Culb.	Chicita Frances 
C.F.Fang	Cheng Fu Fang 
C.F.Gaertn.	Karl Friedrich von Gaertner 
C.Fisch	Carl Fisch 
C.F.Reed	Clyde Franklin Reed 
C.F.Schmidt	Carl Friedrich Schmidt 
C.Gao	Chien Gao 
C.G.F.Hochst.	Christian Gottlob Ferdinand von Hochstetter 
C.G.Matthew	Charles Geekie Matthew 
Chabaud	J.Benjamin Chabaud 
Chaix	Dominique Chaix 
Chakrav.	Hira Lal Chakravarty 
Cham.	Adelbert von Chamisso 
Chamb.	Charles Joseph Chamberlain 
Champ.	John George Champion 
Chantar.	Pranom Chantaranothai 
Chapm.	Alvan Wentworth Chapman 
Chase	Mary Agnes Chase 
Chassot	Philippe Chassot 
Châtel.	Jean Jacques Châtelain 
Chatton	Édouard Chatton 
Chaub.	Louis Athanase Chaubard 
Chaumeton	François-Pierre Chaumeton 
C.H.Blom	Carl Hilding Blom 
C.H.Curtis	Charles Henry Curtis 
C.H.Eberm.	Carl Heinrich Ebermaier 
Cheek	Martin Cheek 
Cheel	Edwin Cheel 
Cheeseman	Thomas Frederic Cheeseman 
Cheesman	Ernest Entwistle Cheesman 
C.H.Ellis	Charles Howard Ellis 
Chenault	Léon Chenault 
Cherd.	Valentina Yakovlevna Cherdantseva 
Cheremis.	Elena Andreevna Cheremisinova 
Cherler	Johann Heinrich Cherler 
Cherm.	Henri Chermezon 
Cherm.Mir.	Vicente Chermont de Miranda 
Cheshm.	Ilija Vasilev Cheshmedjiev 
Chess.	Pascale Chesselet 
Chevall.	François Fulgis Chevallier 
Chi.C.Lee	Ch'ien C. Lee 
Chilton	Charles Chilton 
Ching	Ren-Chang Ching 
Chiov.	Emilio Chiovenda 
Chiron	Guy Robert Chiron 
Chitaley	Shya Chitaley 
C.H.Lank.	Charles Herbert Lankester 
C.H.Mull.	Cornelius Herman Muller 
Chodat	Robert Hippolyte Chodat 
Choisy	Jacques Denys Choisy 
Cholnoky	Béla Jenö Cholnoky 
Chopinet	Robert G. Chopinet 
Christ	Konrad H. Christ 
Christian	Hugh Basil Christian 
Christoph.	Erling Christophersen 
Chrtek	Jindřich Chrtek 
Chud.	René Chudeau 
Chun	Woon Young Chun 
C.H.Wright	Charles Henry Wright 
Cif.	Raffaele Ciferri 
Cirillo	Domenico Cirillo 
C.J.Brand	Charles John Brand 
C.J.Gould	Charles Jay Gould 
C.Kramer	Carl Kramer 
C.Krauss	Christian Ferdinand Friedrich von Krauss 
C.K.Schneid.	Camillo Karl Schneider 
C.K.Spreng.	Christian Konrad 
Claassen	Martha Isabella Claassen 
Clairv.	Joseph Philippe de Clairville 
Clap.	Jean Louis René Antoine Édouard Claparède 
Clapperton	Bain Hugh Clapperton 
Clarion	Jacques Clarion 
Clark	Jane Jessie Clark 
Clarke	Benjamin Clarke 
Clarkson	Edward Hale Clarkson 
Claus	Karl Ernst Claus 
C.L.Boynton	Charles Lawrence Boynton 
Cleghorn	Hugh Francis Clarke Cleghorn 
Cleland	John Burton Cleland 
Clem.	Frederick Edward Clements 
Clémencet	Marien Clémencet 
Clémençon	Heinz Clémençon 
Clement	Ian Duncan Clement 
Clemente	Simón de Roxas 
Clementi	Giuseppe C. Clementi 
Clem.-Muñoz	M. Clemente-Muñoz 
C.L.Fenton	Carroll Lane Fenton 
C.L.Hitchc.	Charles Leo Hitchcock 
Clifford	Harold Trevor Clifford 
Clifton	George Clifton 
Clinton	George William Clinton 
C.L.Leakey	Colin Louis Avern Leakey 
Clos	Dominique Clos 
Clover	Elzada Urseba Clover 
C.L.Scott	Charles Leslie Scott 
Clus.	Carolus Clusius 
Clute	Willard Nelson Clute 
C.L.Woodw.	Catherine L. Woodward 
C.Marquand	Cecil Victor Boley Marquand 
C.Martin	Charles-Édouard Martin 
C.Massal.	Caro Benigno Massalongo 
C.Merck	Carl Merck 
C.Mohr	Charles Theodore Mohr 
C.Morren	Charles François Antoine Morren 
C.Nelson	Cirilo Nelson 
C.N.Forbes	Charles Noyes Forbes 
C.Norman	Cecil Norman 
Co	Leonardo Legaspi Co 
Coaz	Johann Coaz 
Cobb	Nathan Augustus Cobb 
Cocc.	Girolamo Cocconi 
Cockayne	Leonard C. Cockayne 
Cockburn	Peter Francis Cockburn 
Cockerell	Theodore Dru Alison Cockerell 
Cocks	John Cocks 
Cocquyt	Christine Cocquyt 
Codd	Leslie Edward Wostall Codd 
Cogn.	Alfred Cogniaux 
Cogollo	Alvaro Cogollo 
Cohn	Ferdinand Julius Cohn 
Coincy	Auguste Henri Cornut de Coincy 
Coker	William Chambers Coker 
Colden	Jane Colden 
Colebr.	Henry Thomas Colebrooke 
Colenso	William Colenso 
Colla	Luigi Aloysius Colla 
Collad.	Louis Théodore Frederic Colladon 
Collett	Henry Collett 
Collie	Alexander Collie 
Collins	Frank Shipley Collins 
Collinson	Peter Collinson 
Colomb	Marie Louis Georges Colomb 
Columbus	James Travis Columbus 
Comm.	Philibert Commerçon 
Compton	Robert Harold Compton 
Cond.	Charles Marie de la Condamine 
Conger	Paul Sidney Conger 
Conrad	Solomon White Conrad 
Conran	John Godfrey Conran 
Console	Michelangelo Console 
Constance	Lincoln Constance 
Conw.	Hugo Conwentz 
Conz.	Cassiano Conzatti 
Cook	James Cook 
Cooke	Mordecai Cubitt Cooke 
Cookson	Isabel Clifton Cookson 
Cooper	Daniel Cooper 
Cooperr.	Tom Smith Cooperrider 
Cope	Thomas Arthur Cope 
Copel.	Edwin Bingham Copeland 
Corb.	François Marie Louis Corbière 
Cordem.	Eugène Jacob de Cordemoy 
Core	Earl Lemley Core 
Corill.	Robert J. Corillion 
Corner	Edred John Henry Corner 
Cornut	Jaques-Philippe Cornut 
Corrêa	José Francisco Corrêa da Serra 
Correll	Donovan Stewart Correll 
Correns	Carl Correns 
Cortés	Santiago Cortés 
Cortesi	Fabrizio Cortesi 
Cory	Victor Louis Cory 
Coss.	Ernest Saint-Charles Cosson 
Costantin	Julien Noël Costantin 
Cotton	Arthur Disbrowe Cotton 
Coult.	Thomas Coulter 
Courchet	Lucien Désiré Joseph Courchet 
Courtec.	Régis Courtecuisse 
Coustur.	Paul Cousturier 
Cout.	António Xavier Pereira Coutinho 
Coville	Frederick Vernon Coville 
Cowan	John Macqueen Cowan 
Cowles	Henry Chandler Cowles 
Cowley	Elizabeth Jill Cowley 
Cox	Euan Hillhouse Methven Cox 
C.Palmer	Charles Mervin Palmer 
C.P.Raju	C. Prabhakar Raju 
C.Presl	Carl Borivoj Presl 
C.P.Robin	Charles Philippe Robin 
C.P.Sm.	Charles Piper Smith 
Crabbe	James Albert Crabbe 
Crabtree	D. R. Crabtree 
Cragin	Francis Whittemore Cragin 
Craib	William Grant Craib 
Craig	Thomas Craig 
Cralley	Elza Monroe Cralley 
C.Ramesh	Ch. Ramesh 
Crampton	Beecher Crampton 
Crand.	Bowen Sinclair Crandall 
Crand.-Stotl.	Barbara Jean Crandall-Stotler 
Crane	Fern Ward Crane 
Cranfield	Raymond Jeffrey Cranfield 
Cranfill	Raimond Cranfill 
Crantz	Heinrich Johann Nepomuk von Crantz 
Cranwell	Lucy May Cranwell 
Cranz	David Cranz 
Cratty	Robert Irvin Cratty 
Craveiro	Sandra Carla Craveiro 
Craven	Lyndley Alan Craven 
Crawshay	Richard Crawshay 
C.R.Ball	Carleton Roy Ball 
C.R.Bell	Clyde Ritchie Bell 
C.Rchb.	Carl 
C.Regel	Constantin Andreas von Regel 
Crép.	Francois Crépin 
Crins	William J. Crins 
C.Ríos	Carlos Ríos 
C.Rivière	Charles Marie Rivière 
Croat	Thomas Bernard Croat 
Croizat	Léon Camille Marius Croizat 
Cronk	Quentin Cronk 
Cronquist	Arthur John Cronquist 
Crossl.	Charles Crossland 
C.R.P.Andrews	Cecil Rollo Payton Andrews 
C.R.Parks	Clifford R. Parks 
Crundw.	Alan Crundwell 
Crusio	Wim Crusio 
C.Schultze	Christian Friedrich Schultze 
C.Siebold	Karl 
C.S.Li	Cheng Sen Li 
C.T.Gaudin	Charles Théophile Gaudin 
C.Tul.	Charles Tulasne 
C.T.White	Cyril Tenison White 
Cuatrec.	José Cuatrecasas 
Cufod.	Georg Cufodontis 
Culham	Alastair Culham 
Cullum	Thomas Gery Cullum 
Culm.	Paul Frederic Culmann 
Cuming	Hugh Cuming 
Cumm.	Clara Eaton Cummings 
Cumming	William Archibald Cumming 
Cummins	George Baker Cummins 
Curie	Peter Friedrich Curie 
Curl	Herbert Charles Curl 
Curn.	William Curnow 
Curr.	Frederick Currey 
Currah	Randolph S. Currah 
Curran	Mary Katharine Curran 
Currie	James Nimrod Currie 
Curtis	William Curtis 
Curto	Michael Leonard Curto 
Curzi	Mario Curzi 
Cutak	Ladislaus Cutak 
Cuvier	Georges Cuvier 
C.Velásquez	César Velásquez 
C.V.Hartm.	Carl Vilhelm Hartman 
C.V.Morton	Conrad Vernon Morton 
C.Walcott	Charles Doolittle Walcott 
C.Walter	Charles Walter 
C.W.Andrews	Charles William Andrews 
C.Weber	Claude Weber 
C.Winslow	Charles Frederick Winslow 
C.W.Powell	Charles Wesley Powell 
C.Wright	Charles Wright 
C.W.Schneid.	Craig William Schneider 
C.W.Thomson	Charles Wyville Thomson 
C.Y.Wang	Chang Yong Wang 
C.Y.Wu	Cheng Yih Wu 
Czerep.	Sergei Kirillovich Czerepanov 
Czern.	Vassilii Matveievitch Czernajew 
C.Z.Nelson	Carl Z. Nelson 
D.A.Herb.	Desmond Andrew Herbert 
Dahl	Anders Dahl 
Dahlst.	Gustav Adolf Hugo Dahlstedt 
Daléchamps	Jacques Daléchamps 
Dallim.	William Dallimore 
Dalzell	Nicol Alexander Dalzell 
Dalziel	John McEwan Dalziel 
D'Amato	Giovanni Frederico D'Amato 
Dammer	Carl Lebrecht Udo Dammer 
Dana	James Dwight Dana 
Dandy	James Edgar Dandy 
Danert	Siegfried Danert 
Danesi	L. Danesi 
Danet	Frédéric Danet 
Danguy	Paul Auguste Danguy 
Daniell	William Freeman Daniell 
Daniels	Francis Potter Daniels 
Danielsen	Anders Danielsen 
Danihelka	Jiří Danihelka 
Däniker	Albert Ulrich Däniker 
Danin	Avinoam Danin 
Dans.	Pierre Mackay Dansereau 
Danser	Benedictus Hubertus Danser 
Danthoine	D. Danthoine 
Danzé-Corsin	Paule Danzé-Corsin 
Darby	John M. Darby 
Darbysh.	S.J. Darbyshire 
Darl.	William Darlington 
Darling	Samuel Taylor Darling 
D.Arora	David Arora 
Darwin	Charles Darwin 
D.A.Sutton	David A. Sutton 
Daubs	Edwin Horace Daubs 
Daveau	Jules Alexandre Daveau 
Davenp.	George Edward Davenport 
Davey	Frederick Hamilton Davey 
David	Armand David 
Davidse	Gerrit Davidse 
Davis	John Jefferson Davis 
D.A.Webb	David Allardice Webb 
Dawson	John William Dawson 
D.Brândză.	Dimitrie Brândză 
DC.	Augustin Pyramus de Candolle 
D.C.Eaton	Daniel Cady Eaton 
D.C.McClint.	David Charles McClintock 
D.C.Stuart	D.C. Stuart 
D.D.Baldwin	David Dwight Baldwin 
D.D.Cunn.	David Douglas Cunningham 
D.Dietr.	David Nathaniel Dietrich 
D.D.Keck	David D. Keck 
D.Don	David Don 
D.Donati	Davide Donati 
D.D.Perkins	David Dexter Perkins 
D.Drake	Daniel Drake 
D.D.Tao	De Ding Tao 
Deam	Charles Clemon Deam 
de Bary	Anton de Bary 
Debeaux	Jean Odon Debeaux 
D.E.Beetle	Dorothy Erna Beetle 
Decne.	Joseph Decaisne 
D.Edwards	Dianne Edwards 
De Franceschi	D. De Franceschi 
Degen	Àrpàd von Degen 
Deguchi	Hironori Deguchi 
Dehnh.	Friedrich Dehnhardt 
de Kruif	A.P.M. de Kruif 
Delahouss.	A. James Delahoussaye 
de Laub.	David John de Laubenfels 
Delavay	Pierre Jean Marie Delavay 
D.E.Lee	Daphne Euphemia Lee 
Deless.	Jules Paul Benjamin Delessert 
Delf	Ellen Marion Delf 
Delile	Alire Raffeneau Delile 
Demoly	Jean-Pierre Demoly 
Dempster	Lauramay Tinsley Dempster 
De M.Wang	De-Ming Wang 
Denham	Dixon Denham 
Deniker	Joseph Deniker 
Denis	Marcel Denis 
De Not.	Giuseppe De Notaris 
Deplanche	Émile Deplanche 
Deppe	Ferdinand Deppe 
De Puydt	Paul Émile de Puydt 
Derbès	August Alphonse Derbès 
de Roon	Adrianus Cornelis de Roon 
Deschamps	Louis Auguste Deschamps 
Déségl.	Pierre Alfred Déséglise 
Desf.	René Louiche Desfontaines 
De Smet	Louis De Smet 
Des Moul.	Charles Robert Alexandre des Moulins 
Desp.	J.M. Despreaux 
Desr.	Louis Auguste Joseph Desrousseaux 
Desv.	Nicaise Auguste Desvaux 
Detmers	Freda Detmers 
De Vis	Charles Walter De Vis 
de Vogel	Eduard Ferdinand de Vogel 
de Vos	Cornelis de Vos 
de Vries	Hugo de Vries 
de Vriese	Willem Hendrik de Vriese 
de Wet	Johannes Martenis Jacob de Wet 
Dewèvre	Alfred Aloys Dewèvre 
Dewey	Chester Dewey 
De Wild.	Émile Auguste Joseph De Wildeman 
De Winter	Bernard de Winter 
de Wit	Hendrik de Wit 
D.Fairchild	David Fairchild 
D.Fang	Ding Fang 
D.F.Austin	Daniel Frank Austin 
D.F.Fisch.	Daniel Ferdinand Heinrich Albert Fischer 
D.G.Lloyd	David Graham Lloyd 
D.G.Long	David Geoffrey Long 
D.Hanb.	Daniel Hanbury 
D.Hawksw.	David Leslie Hawksworth 
D.H.Scott	Dukinfield Henry Scott 
D.H.Wagner	David H. Wagner 
Dice	James C. Dice 
Dicks.	James 
Didr.	Didrik Ferdinand Didrichsen 
Dieck	Georg Dieck 
Dieckmann	Juana G. Dieckmann 
Died.	Hermann Diedicke 
Dieder.	Christoph Diederichs 
Diederich	Paul Diederich 
Diederichsen	Axel Diederichsen 
Diego	Nelly Diego 
Diego-Esc.	Valentina Diego-Escobar 
Diehl	William Webster Diehl 
Diekm.	Rolf Diekmann 
Diels	Friedrich Ludwig Emil Diels 
Diem	José Diem 
Dien	B.S. Dien 
Dierb.	Johann Heinrich Dierbach 
Dierckx	Frans Dierckx 
Diers	Lothar Diers 
Diesing	Karl 
Dietel	Paul Dietel 
Dieter.	Carl Friedrich Dieterich 
Dieterle	Jennie van Ackeren Dieterle 
Dietrichson	E. Dietrichson 
Dietz	Samuel M. Dietz 
Dietzow	W. Ludwig von Dietzow 
Diguet	Léon Diguet 
Dill.	Johann Jacob Dillenius 
Dillwyn	Lewis Weston Dillwyn 
Dilst	Floor J. H. van Dilst 
D.I.Morris	Dennis Ivor Morris 
Ding Hou	Ding Hou 
Dinsm.	John Edward Dinsmore 
Dinter	Moritz Kurt Dinter 
Dippel	Leopold Dippel 
Dissing	Henry Dissing 
D.J.Middleton	David John Middleton 
D.Legrand	Carlos Maria Diego Enrique Legrand 
D.Livingstone	David Livingstone 
D.L.Jacobs	Donald Leroy Jacobs 
D.L.Jones	David Lloyd Jones 
D.Löve	Doris Löve 
D.L.Roberts	David Lesford Roberts 
D.M.Andrews	Darwin Maxson Andrews 
D.M.Hend.	Douglas Mackay Henderson 
D.M.Moore	David Moresby Moore 
D.Mohr	Daniel Matthias Heinrich Mohr 
D.Müll.-Doblies	Dietrich Müller-Doblies 
D.Naras.	D. Narasimhan 
Dobell	Clifford Dobell 
Dod	Donald Dungan Dod 
Dode	Louis-Albert Dode 
Dodoens	Rembert Dodoens 
Dodson	Calaway Homer Dodson 
Döll	Johann Christoph Döll 
Dollfus	Gustave Frédéric Dollfus 
Dombrain	Henry Honywood Dombrain 
Domin	Karel Domin 
Domke	Friedrich Walter Domke 
Donn	James Donn 
Donn.Sm.	John Donnell Smith 
Door.	Simeon Gottfried Albert Doorenbos 
Dop	Paul Louis Amans Dop 
Dorf	Erling Dorf 
Dörfelt	Heinrich Dörfelt 
Doronkin	V.M. Doronkin 
Dorr	Laurence Joseph Dorr 
Dorsett	Palemon Howard Dorsett 
Dostál	Josef Dostál 
Douglas	David Douglas 
Douglass M.Hend.	Douglass Miles Henderson 
Douin	Charles Isidore Douin 
Doum.	François Doumergue 
Doust	Andrew N.L. Doust 
Doweld	Alexander Borissovitch Doweld 
Dowell	Philip Dowell 
D.Parodi	Domingo Parodi 
D.Popenoe	Dorothy Kate Popenoe 
Drabble	Eric Frederic Drabble 
Drake	Emmanuel Drake del Castillo 
Drees	Friedrich Wilhelm Drees
Drège	Johann Franz Drège 
Dressler	Robert Louis Dressler 
D.R.Hunt	David Richard Hunt 
Dring	Donald Malcolm Dring 
Druce	George Claridge Druce 
Drude	Carl Georg Oscar Drude 
Dryand.	Jonas Carlsson Dryander 
D.S.Edwards	David Sydney Edwards 
D.Thomas	David Thomas 
Dubard	Marcel Marie Maurice Dubard 
Duboscq	Octave Joseph Duboscq 
Duby	Jean Étienne Duby 
Duch.	Pierre Étienne Simon Duchartre 
Duchass.	Édouard Placide Duchassaing de Fontbressin 
Duchesne	Antoine Nicolas Duchesne 
Ducke	Adolpho Ducke 
Duclaux	Émile Duclaux 
Dufft	Adolf Dufft 
Dufour	Léon Jean Marie Dufour 
Dufr.	Pierre Dufresne 
Dugand	Armando Dugand 
Duggar	Benjamin Minge Duggar 
Dulac	Joseph Dulac 
Dum.Cours.	Georges Louis Marie Dumont de Courset 
Dümmer	Richard Arnold Dümmer 
Dumort.	Barthélemy Charles Joseph Dumortier 
Dunal	Michel Félix Dunal 
Dunn	Stephen Troyte Dunn 
Dupr.	François Hippolyte Dupret 
Dupuy	Dominique Dupuy 
Duque	Jaramillo Jesus Maria Duque 
Durand	Elias 
Durazz.	Antonio Durazzini 
Durieu	Michel Charles Durieu de Maisonneuve 
Du Roi	Johann Philipp Du Roi 
Dürrnb.	Adolf Dürrnberger 
d'Urv.	Jules Sébastian César Dumont d'Urville 
Dusén	Per Karl Hjalmar Dusén 
Duss	Antoine Duss 
Duthie	John Firminger Duthie 
Duval	Henri August Duval 
Duyfjes	Brigitta Emma Elisabeth Duyfjes 
D.Vidal	Domingo Vidal 
Dw.Moore	Dwight Munson Moore 
Dwyer	John Duncan Dwyer 
Dyal	Sarah Creecie Dyal 
Dyer	William Turner Thiselton 
Dykes	William Rickatson Dykes 
D.Zohary	Daniel Zohary 
E.A.Br.	Elizabeth Anne Brown 
E.A.Durand	Ernest Armand Durand 
E.A.Hodgs.	Eliza Amy Hodgson 
E.A.Mennega	Erik Albert Mennega 
Eames	Edwin Hubert Eames 
Earle	Franklin Sumner Earle 
E.A.Rob.	Edward Armitage Robinson 
E.A.Sánchez	Evangelina A. Sánchez 
Eastw.	Alice Eastwood 
Eaton	Amos Eaton 
E.A.White	Edward Albert White 
E.B.Alexeev	Evgenii Borisovich Alexeev 
E.B.Andrews	Ebenezer Baldwin Andrews 
E.B.Bartram	Edwin Bunting Bartram 
Eberm.	Johann Erdwin Christoph Ebermaier 
Eb.Fisch.	Eberhard Fischer 
Ebinger	John Edwin Ebinger 
E.B.Knox	Eric B. Knox 
E.Britton	Elizabeth Gertrude Britton 
E.C.Hall	Edwin Cuthbert Hall 
E.C.Hansen	Emil Christian Hansen 
Eckblad	Finn-Egil Eckblad 
Eckl.	Christian Friedrich Ecklon 
E.C.Nelson	Ernest Charles Nelson 
E.Cordus	Euricius Cordus 
E.C.Wallace	Edward Charles Wallace 
E.Danesch	Edeltraud Danesch 
E.D.Clarke	Edward Daniel Clarke 
Eddy	Caspar Wistar Eddy 
É.Desv.	Étienne-Émile Desvaux 
Edgew.	Michael Pakenham Edgeworth 
E.D.Liu	En-De Liu 
Edmondston	Thomas Edmondston 
E.D.Schulz	Ellen Dorothy Schulz 
Edwin	Gabriel Edwin 
Eeden	Frederik Willem van Eeden 
E.E.Lamont	Eric E. Lamont 
E.E.Nelson	Elias Emanuel Nelson 
E.E.Wilson	Edward Elmer Wilson 
E.Fisch.	Eduard Fischer 
E.Forbes	Edward Forbes 
E.Fourn.	Eugène Pierre Nicolas Fournier 
E.F.Warb.	Edmund Frederic Warburg 
E.G.Andrews	Elisabeth G. Andrews, later Hooper 
E.G.Camus	Edmond Gustave Camus 
E.G.Clem.	Edith Gertrude 
Eggeling	William Julius Eggeling 
Eggers	Henrik Franz Alexander von Eggers 
Eggl.	Willard Webster Eggleston 
E.G.H.Oliv.	Edward George Hudson Oliver 
Egler	Frank Edwin Egler 
Egli	Bernhard Egli 
E.G.Voss	Edward Groesbeck Voss 
E.Hitchc.	Edward Hitchcock 
E.H.L.Krause	Ernst Hans Ludwig Krause 
Ehrenb.	Christian Gottfried Ehrenberg 
Ehrend.	Friedrich Ehrendorfer 
Ehret	Georg Dionysius Ehret 
Ehrh.	Jakob Friedrich Ehrhart 
E.H.Wilson	Ernest Henry Wilson 
Eichler	August Wilhelm Eichler 
Eichw.	Karl Eduard von Eichwald 
Eig	Alexander Eig 
E.Ives	Eli Ives 
E.James	Edwin P. James 
E.J.Butler	Edwin John Butler 
E.J.Clement	E.J. Clement 
E.J.Dunn	Edward John Dunn 
E.-J.Gilbert	Edouard-Jean Gilbert 
E.J.Lowe	Edward Joseph Lowe 
E.J.Palmer	Ernest Jesse Palmer 
E.J.Quekett	Edwin John Quekett 
E.J.Schmidt	Ernst Johannes Schmidt 
Ekman	Erik Leonard Ekman 
E.Lawton	Elva Lawton 
E.L.Braun	Emma Lucy Braun 
E.L.Cabral	Elsa Leonor Cabral 
É.Lemoine	Émile Lemoine 
Elisens	Wayne J. Elisens 
Elliott	Stephen Elliott 
Ellis	Job Bicknell Ellis 
Ellw.	George Ellwanger 
Elmer	Adolph Daniel Edward Elmer 
E.L.Robertson	Enid Lucy Robertson 
E.L.Schneid.	Edward L. Schneider 
Elwes	Henry John Elwes 
E.L.Wolf	Egbert Ludwigowitsch Wolf 
E.Martin	Émile Martin 
E.Martínez	Esteban Martínez 
E.Mayer	Ernest Mayer 
E.Mey.	Ernst Heinrich Friedrich Meyer 
E.M.Friis	Else Marie Friis 
E.M.McClint.	Elizabeth May McClintock 
E.M.Norman	Eliane Meyer Norman 
E.M.O.Martins	Elena Maria Occioni Martins 
E.Morren	Charles Jacques Édouard Morren 
Emory	William Hemsley Emory 
Enderlein	Günther Enderlein 
Endert	Frederik Hendrik Endert 
Endl.	Stephan Friedrich Ladislaus Endlicher 
E.Nelson	Erich Nelson 
Engel	Franz Engel 
Engelm.	Georg Engelmann 
Engl.	Heinrich Gustav Adolf Engler 
E.N.Lowe	Ephriam Noble Lowe 
E.O.Campb.	Ella Orr Campbell 
E.O.Schmidt	Eduard Oscar Schmidt 
E.Palmer	Elmore Palmer 
E.P.Bicknell	Eugene Pintard Bicknell 
E.Peter	Elfriede Peter-Stibal 
E.Phillips	Edwin Percy Phillips 
Epling	Carl Clawson Epling 
E.P.Perrier	Eugène Pierre Perrier de la Bâthie 
E.Pritz.	Ernst Georg Pritzel 
E.P.Wright	Edward Perceval 
Erdman	Kimball Stewart Erdman 
Erdtman	Otto Gunnar Elias Erdtman 
E.Rev.	Elisée Reverchon 
E.R.Noble	Elmer Ray Noble 
Ernst	Adolf Ernst 
E.Robson	Edward Robson 
E.Rosén	Eberhard Rosén 
Er.Rosen	Eric von Rosen 
E.R.Saunders	Edith Rebecca Saunders 
E.Sabine	Edward Sabine 
E.Salisb.	Edward James Salisbury 
E.S.Anderson	Edgar Shannon Anderson 
E.S.Barton	Ethel Sarel Barton 
E.S.Burgess	Edward Sandford Burgess 
E.Schenk	Ernst Schenk 
E.Schiem.	Elisabeth Schiemann 
Eschsch.	Johann Friedrich von Eschscholtz 
E.Sheld.	Edmund Perry Sheldon 
E.Simon	Eugène Ernest Simon 
E.Small	Ernest Small 
E.S.Martins	Eurico Sampaio Martins 
Esper	Eugenius Johann Christoph Esper 
E.S.Steele	Edward Strieby Steele 
Esterh.	Elsie Elizabeth Esterhuysen 
Esteves	Eddie Esteves Pereira 
E.T.Barthol.	Elbert Thomas Bartholomew 
Ether.	Robert Etheridge, Jr. 
E.Thurst.	Edgar Thurston 
Etl.	Andreas Ernst Etlinger 
E.T.Newton	Edwin Tulley 
Ettingsh.	Constantin von Ettingshausen 
Euphrasén	Bengt Anders Euphrasén 
E.Vilm.	Elisa de Vilmorin 
Ewart	Alfred James Ewart 
E.W.Berry	Edward Wilber Berry 
E.W.Herv.	Eliphalet Williams Hervey 
E.Willm.	Ellen Ann Willmott 
E.W.Jones	Eustace Wilkinson Jones 
E.W.Nelson	Edward William Nelson 
Exell	Arthur Wallis Exell 
E.Y.Dawson	Elmer Yale Dawson 
Eyde	Richard H. Eyde 
Eyles	Frederick Eyles 
Eyre	William Leigh Williamson Eyre 
E.Z.Bailey	Ethel Zoe Bailey 
F.A.Barkley	Fred Alexander Barkley 
F.A.Bartlett	Francis Alonzo Bartlett 
F.A.Bauer	Franz 
Fabr.	Philipp Conrad Fabricius 
F.A.C.Weber	Frédéric Albert Constantin Weber 
Faegri	Knut Fægri 
Fahn	Avraham 
Fairon-Dem.	Muriel Fairon-Demaret 
F.Albers	Focke Albers 
Falc.	Hugh Falconer 
Falck	Richard Falck 
Falk	Johan Peter 
Falkenb.	Paul Falkenberg 
F.Allam.	
Fanning	Una Fanning 
Farges	Paul Guillaume Farges 
Farjon	Aljos Farjon 
Farl.	William Gilson Farlow 
F.A.Rogers	Frederick Arundel Rogers 
Farrer	Reginald John Farrer 
Farron	Claude Farron 
Farw.	Oliver Atkins Farwell 
Fassat.	Olga Fassatiová 
Fassett	Norman Carter Fassett 
Favre	Louis Favre 
Fawc.	William Fawcett 
Faxon	Charles Edward Faxon 
Fayod	Victor Fayod 
F.B.Forbes	Francis Blackwell Forbes 
F.Bolle	Friedrich Franz August Albrecht Bolle 
F.Bolus	Frank Bolus 
F.Boos	Franz Boos 
F.Br.	Forest Buffen Harkness Brown 
F.Brachet	Flavien Brachet 
F.B.White	Francis Buchanan White 
F.Chapm.	Frederick Chapman 
F.C.How	Foon Chew How 
F.Cuvier	Georges-Frédéric Cuvier 
F.Delaroche	François Delaroche 
F.Dietr.	Friedrich Gottlieb Dietrich 
F.E.Boynton	Frank Ellis Boynton 
Fed.	Andrey Aleksandrovich Fedorov 
Fedde	Friedrich Karl Georg Fedde 
Fée	Antoine Laurent Apollinaire Fée 
F.E.Fritsch	Felix Eugen Fritsch 
Feinbrun	Naomi Feinbrun 
Feldman	Moshe Feldman 
F.E.Leyb.	Friedrich Ernst Leibold 
F.E.Lloyd	Francis Ernst Lloyd 
Fenzl	Eduard Fenzl 
Ferd.Schneid.	Ferdinand Schneider 
Fernald	Merritt Lyndon Fernald 
Fern.Alonso	José Luis Fernández Alonso 
Fernando	Edwino S. Fernando 
Fern.-Vill.	Celestino Fernández-Villar 
Ferry	René Joseph Justin Ferry 
Feuillée	Louis Éconches Feuillée 
F.F.Blackman	Frederick Blackman 
F.Friedmann	Francis Friedmann 
F.G.Wallace	Franklin Gerhard Wallace 
F.Hanb.	Frederick Janson Hanbury 
F.Harper	Francis Harper 
F.H.Chen	Chen Feng Huai 
F.Heim	Frédéric Louis Heim 
F.Heller	Franz Xaver Heller 
F.H.Lewis	Frank Harlan Lewis 
F.H.Wigg.	Friedrich Heinrich Wiggers 
Ficalho	Franciso Manoel Carlos de Mello de Ficalho 
Fieber	Franz Xaver Fieber 
Field	Henry Claylands Field 
Fielding	Henry Barron Fielding 
Figlar	Richard B. Figlar 
Finet	Achille Eugène Finet 
Finl.	George Finlayson 
Finschow	Günter Finschow 
Fiori	Adriano Fiori 
Fisch.	Friedrich Ernst Ludwig von Fischer 
Fisch.-Benz.	Rudolf J. D. von Fischer-Benzon 
Fisch.-Oost.	Carl von Fischer-Ooster 
Fisch.Waldh.	Alexander Gregorevich Fischer von Waldheim 
Fitch	Walter Hood Fitch 
Fitschen	Jost Fitschen 
Fitzg.	Robert D. FitzGerald 
F.J.A.Morris	Francis John A. Morris 
F.J.F.Shaw	Frederick John Freshwater Shaw 
F.J.Herm.	Frederick Joseph Hermann 
F.J.Schultz	Franz Johann Schultz 
Flahault	Charles Flahault 
F.L.Bauer	Ferdinand Lucas 
F.Lees	Frederick Arnold Lees 
Fleming	John Fleming 
F.L.Erickson	Frederica Lucy "Rica" Erickson 
Flerow	Alexandr Fedorovich Flerow 
F.Lestib.	François Joseph Lestiboudois 
Fletcher	James Fletcher 
Flinders	Matthew Flinders 
F.L.Martin	Floyd Leonard Gabriel Martin 
Flod.	Björn Gustaf Oscar Floderus 
Flörke	Heinrich Gustav Flörke 
Flot.	Julius von Flotow 
F.L.Tai	Fung Lan Tai 
F.Ludw.	Friedrich Ludwig 
Flueck.	Friedrich August Flückiger 
Flüggé	Johannes Flüggé 
F.M.Bailey	Frederick Manson Bailey 
F.Michx.	François Andre Michaux 
F.M.Knuth	Frederik Marcus Knuth 
F.M.Leight.	Frances Margaret Leighton 
F.Muell.	Ferdinand von Mueller 
F.N.Meyer	Frank Nicholas Meyer 
Fobe	Frederich Fobe 
Focke	Wilhelm Olbers Focke 
Foldats	Ernesto Foldats Andins 
Fomin	Aleksandr Vasiljevich Fomin 
Font Quer	Pius Font i Quer 
Forbes	John Forbes 
Forman	Lewis Leonard Forman 
Forrest	George Forrest 
Forssk.	Peter Forsskål 
Forsstr.	Johan Erik Forsström 
Forsyth	William Forsyth 
Fortune	Robert Fortune 
Fosberg	Francis Raymond Fosberg 
Foster	Michael Foster 
Foucaud	Julien Foucaud 
Foug.	Auguste Denis Fougeroux de Bandaroy 
Fourc.	Henry Georges Fourcade 
Fourcy	Michel-Eugène Lefébure de Fourcy 
Fourn.	Eugène Pierre Nicolas Fournier 
Fourr.	Jules Pierre Fourreau 
Fox	T. Colcott Fox 
Foxw.	Frederick William Foxworthy 
F.Patt.	Flora Wambaugh Patterson 
F.Phil.	Federico Philippi 
Fr.	Elias Magnus Fries 
Fraas	Carl Nicolaus Fraas 
Franch.	Adrien René Franchet 
Francis	George William Francis 
Franco	João Manuel Antonio do Amaral Franco 
Franc.-Ort.	Javier Francisco-Ortega 
Fraser	John Fraser 
Fraser f.	John Fraser Jr. 
Frauenfeld	Georg von Frauenfeld 
F.R.Chapm.	Frederick Revans Chapman 
Freckmann	Robert W. Freckmann 
Freire-Fierro	Alina Freire-Fierro 
Frém.	John C. Frémont 
Fresen.	Johann Baptist Georg Wolfgang Fresenius 
Freyer	Heinrich Freyer 
Freyn	Josef Franz Freyn 
Frez.	Amédée-François Frézier 
Frič	Alberto Vojtěch Frič 
Friedrich	Hans Christian Friedrich 
Friis	Ib Friis 
Fritsch	Karl Fritsch 
F.Ritter	Friedrich Ritter 
Friv.	Imre 
Frodin	David Gamman Frodin 
Froel.	Joseph Aloys von Froelich 
Fronius	Franz Friedrich Fronius 
F.Rose	Francis Rose 
Fr.Römer	Fritz Römer 
Fr.Schneid.	Frits Schneider 
F.Rudolphi	Friedrich Karl Ludwig Rudolphi 
Fryer	Alfred Fryer 
F.Schmidt	Friedrich Carl Fedor Bogdanovich Schmidt 
F.Stein	Samuel Friedrich Nathaniel Ritter von Stein 
F.T.Brooks	Frederick Tom 
F.T.Hubb.	Frederic Tracy Hubbard 
F.Turner	Frederick Turner 
Fuckel	Karl Wilhelm Gottlieb Leopold Fuckel 
Fukuhara	Tatsundo Fukuhara 
Fukuoka	Nobuyuki Fukuoka 
Fukuy.	Noriaki Fukuyama 
Funck	Heinrich Christian Funck 
Furuki	Tatsuwo Furuki 
F.Vierh.	Friedrich Vierhapper 
F.Voigt	Friedrich Siegmund Voigt 
F.W.Andrews	Frederick William Andrews 
F.Weber	Friedrich Weber 
F.Wettst.	Fritz von Wettstein 
F.White	Frank White 
F.Wilson	Francis Robert Muter Wilson 
F.Wirtg.	Ferdinand Paul Wirtgen 
F.W.L.Suckow	Friedrich Wilhelm Ludwig Suckow 
F.W.Schmidt	Franz Wilibald Schmidt 
F.W.Schultz	Friedrich Wilhelm Schultz 
F.W.Went	Frits Warmolt Went 
F.Zenker	Friedrich Albert von Zenker 
G.A.Black	George Alexander Black 
Gaertn.	Joseph Gaertner 
Gagnep.	François Gagnepain 
G.A.Klebs	Georg Albrecht Klebs 
Gaill	Charles Gaillardot 
Gaillard	Albert Gaillard 
Gaimard	Joseph Paul Gaimard 
Gale	Shirley Gale Cross 
Galeano	Gloria A. Galeano 
Galeotti	Henri Guillaume Galeotti 
Gallesio	Georgio Gallesio 
Galpin	Ernest Edward Galpin 
Galushko	Anatol I. Galushko 
Gamble	James Sykes Gamble 
Gand.	Michel Gandoger 
Gandhi	Kancheepuram Natarajan Gandhi 
G.A.Noble	Glenn Arthur Noble 
Garay	Leslie Andrew Garay 
Garbari	Fabio Garbari 
García-Barr.	Hernando García-Barriga 
Garcke	Christian August Friedrich Garcke 
Garden	Alexander Garden 
Gardner	George Gardner 
Garsault	François Alexandre Pierre de Garsault 
Gasp.	Guglielmo Gasparrini 
Gatt.	Augustin Gattinger 
Gatty	Margaret Scott Gatty 
Gaudich.	Charles Gaudichaud-Beaupré 
Gäum.	Ernst Albert Gäumann 
Gaussen	Henri Marcel Gaussen 
Gaut.	Marie Clément Gaston Gautier 
G.A.Wallace	G. Ansley Wallace 
G.Bertol.	Giuseppe Bertoloni 
G.Bosc	Georges Bosc 
G.B.Popov	George Basil Popov 
G.Clifford	George Clifford III 
G.C.S.Clarke	Giles C. S. Clarke 
G.C.Tucker	Gordon C. Tucker 
G.Cunn.	Gordon Herriott 
G.C.Wall	George Charles Wallich 
G.C.Whipple	George Chandler Whipple 
G.Dahlgren	Gertrud Dahlgren 
G.Don	George Don 
G.D.Rowley	Gordon Douglas Rowley 
G.D.Wallace	Gary D. Wallace 
G.E.Baker	Gladys Elizabeth Baker 
Geh.	Adalbert Geheeb 
G.E.Haglund	Gustaf Emmanuel Haglund 
Geissler	Ursula Geissler 
G.E.Lee	Gaik Ee Lee 
Gelting	Paul Emil Elliot Gelting 
Genev.	Léon Gaston Genevier 
Gensel	Patricia G. Gensel 
Gentil	Ambroise Gentil 
Gentry	Howard Scott Gentry 
Georgi	Johann Gottlieb Georgi 
Gereau	Roy Emile Gereau 
Gerrienne	Phillipe Gerrienne 
Gerstb.	Pedro Gerstberger 
Gesner	Conrad Gessner 
Getachew	Getachew Aweke 
Geyer	Karl Andreas Geyer 
Geyl.	Hermann Theodor Geyler 
G.F.Atk.	George Francis Atkinson 
G.Fisch.	Georg Fischer 
G.Fisch.Waldh.	Gotthelf Fischer von Waldheim 
G.Forst.	Georg Forster 
G.Gaertn.	Gottfried Gaertner 
G.G.Niles	Grace Greylock Niles 
G.Haller	Gottlieb Emmanuel von Haller 
G.Hend.	George Henderson 
G.Hensl.	George Henslow 
Ghini	Luca Ghini 
G.H.Martin	George Hamilton Martin 
G.H.M.Lawr.	George Hill Mathewson Lawrence 
G.H.S.Wood	Geoffrey H.S. Wood 
G.H.Tate	George Henry Hamilton Tate 
G.H.Wagner	Georg Heinrich Wagner 
G.H.Zhu	Guang Hua Zhu 
Gibbs	Lilian Gibbs 
Giesecke	Karl Ludwig 
Giess	Johan Wilhelm Heinrich Giess 
Gilb.	Robert Lee Gilbertson 
Gilg	Ernest Friedrich Gilg 
Gilg-Ben.	Charlotte Gilg-Benedict 
Gilib.	Jean-Emmanuel Gilibert 
Gillek.	Léopold Guillaume Gillekens 
Gilli	Alexander Gilli 
Gillies	John Gillies 
Gillis	William Thomas Gillis 
Gilly	Charles Louis Gilly 
Gilmour	John Scott Lennox Gilmour 
Ging.	Frédéric Charles Jean Gingins de la Sarraz 
Gir.-Chantr.	Justin Girod-Chantrans 
Giseke	Paul Dietrich Giseke 
Givnish	Thomas J. Givnish 
Gjaerev.	Olav Gjærevoll 
G.J.Lewis	Gwendoline Joyce Lewis 
G.Kirchn.	Georg Kirchner 
G.Koch	Georg Friedrich Koch 
G.Kunkel	Günther W.H. Kunkel 
Glatf.	Noah Miller Glatfelter 
G.Lawson	George Lawson 
Glaz.	Auguste François Marie Glaziou 
G.L.Church	George Lyle Church 
Gleason	Henry Allan Gleason 
Gledhill	David Gledhill 
Glehn	Peter von Glehn 
G.L.Nesom	Guy L. Nesom 
G.Lodd.	George Loddiges 
G.López	Ginés Alejandro López González 
Glover	James Glover 
Gloxin	Benjamin Peter Gloxin 
G.L.Rob.	George Leslie Robinson 
G.L.Webster	Grady Linder Webster 
G.Martens	Georg Matthias von Martens 
G.Martin	George Martin 
G.M.Barroso	Graziela Maciel Barroso 
G.Mey.	Georg Friedrich Wilhelm Meyer 
G.M.Levin	Gregory Moiseyevich Levin 
G.Moore	George Thomas Moore 
G.M.Plunkett	Gregory M. Plunkett 
G.Murray	George Robert Milne Murray 
G.M.Waterh.	Grace Marion Waterhouse 
G.Nicholson	George Nicholson 
G.N.Jones	George Neville Jones 
G.Norman	George Norman 
Goadby	Bede Theodoric Goadby 
Gobi	Christoph Jakosolewitsch Gobi 
God.-Leb.	Alexandre Godefroy-Lebeuf 
Godm.	Frederick DuCane Godman 
Godr.	Dominique Alexandre Godron 
Goebel	Karl Christian Traugott Friedemann Goebel 
Goeldi	Émil August Goeldi 
Goering	Philip Friedrich Wilhelm Goering 
Goeschke	Franz Goeschke 
Goldberg	Aaron Goldberg 
Goldblatt	Peter Goldblatt 
Goldfuss	Georg August Goldfuss 
Goldie	John Goldie 
Goldman	Edward Alphonso Goldman 
Goldring	William Goldring 
Gomb.	René Gombault 
Gomes	Bernardino António Gomes 
Gómez-Campo	César Gómez-Campo 
Gomont	Maurice Augustin Gomont 
Gonez	Paul Gonez 
Gooden.	Samuel Goodenough 
Goodsp.	Thomas Harper Goodspeed 
Goodyer	John Goodyer 
Gopalan	Rangasamy Gopalan 
Göpp.	Johann Heinrich Robert Göppert 
Gordon	George Gordon 
Gorozh.	Ivan Nikolaevich Gorozhankin 
Gossw.	John Gossweiler 
Gottlieb	Leslie David Gottlieb 
Gottsche	Carl Moritz Gottsche 
Goudot	Justin Goudot 
Gould	Frank Walton Gould 
Gourret	Paul Gabriel Marie Gourret 
Govaerts	Rafaël Herman Anna Govaerts 
G.P.Baker	George Percival Baker 
G.Pearson	Gilbert Pearson
G.Perkins	George Henry Perkins 
G.Petersen	Gitte Petersen 
G.P.Lewis	Gwilym Peter Lewis 
Gradst.	Stephan Robbert Gradstein 
Graebn.	Karl Otto Robert Peter Paul Graebner 
Graells	Mariano de la Paz Graëlls y de la Aguera 
Graf	Siegmund Graf 
Graham	Robert Graham 
Grande	Loreto Grande 
Gratel.	Jean Pierre A. Sylvestre de Grateloup 
Grauer	Sebastian Grauer 
Gravely	Frederic Henry Gravely 
Gray	Samuel Frederick Gray 
Gredilla	Apolinar Federico Gredilla y Gauna 
Greene	Edward Lee Greene 
Greenm.	Jesse More Greenman 
Greenway	Percy James Greenway 
Greg.	Eliza Standerwick Gregory 
Gren.	Jean Charles Marie Grenier 
G.Retz.	Magnus Gustaf 
Greuter	Werner Rodolfo Greuter 
Grev.	Robert Kaye Greville 
Grey-Wilson	Christopher Grey-Wilson 
G.R.Hend.	Gemma Robyn Henderson 
Griff.	William Griffith 
Griffioen	K. Griffioen
Griffiths	David Griffiths 
Griggs	Robert Fiske Griggs 
Grimm	Johann Friedrich Carl Grimm 
Grindon	Leopold Hartley Grindon 
Gris	Jean Antoine Arthur Gris 
Griscom	Ludlow Griscom 
Griseb.	August Heinrich Rudolf Grisebach 
Groeninckx	Inge Groeninckx 
Groenland	Johannes Groenland 
Grognier	Louis Furcy Grognier 
Grognot	Camille Grognot 
Grolle	Riclef Grolle 
Gronov.	Johan Frederik 
Groot.	Herman Johannes Grootendorst 
Grossh.	Alexander Alfonsovich Grossheim 
G.Roth	Georg Roth 
Grove	William Bywater Grove 
Gr.Rossi	Graziano Rossi 
Grubov	Valery Ivanovitsch Grubov 
Grudz.	Irina Aleksandrovna Grudzinskaya 
Gruith.	Franz von Paula 
Grumm-Grzhim.	Grigory Grumm-Grzhimaylo 
Grüning	G.R. Grüning 
Grushv.	Igor Vladimirovich Grushvitzky 
G.Scheffler	Georg Scheffler 
G.Schellenb.	Gustav August Ludwig David Schellenberg 
G.Schneid.	George Schneider 
G.Schneid.bis	Georg Schneider 
G.Shaw	George Shaw 
G.Sinclair	George Sinclair 
G.Singh	Gurcharan Singh 
G.S.Mill.	Gerrit Smith Miller 
G.S.Rawat	Gopal Singh Rawat 
G.Stev.	Greta Stevenson 
G.S.West	George Stephen West 
G.Taylor	Sir George Taylor 
G.Tobler	Gertrud Tobler 
G.Trevir.	Gottfried Reinhold Treviranus 
Gueldenst.	Johann Anton Güldenstädt 
Guett.	Jean Étienne Guettard 
Guilding	Lansdown Guilding 
Guill.	Jean Baptiste Antoine Guillemin 
Guillaumin	André Guillaumin 
Guimpel	Friedrich Guimpel 
Guinea	Emilio Guinea López 
Gumbl.	William Edward Gumbleton 
Gunckel	Hugo Gunckel Lűer 
Gunn	Ronald Campbell Gunn 
Gunnerus	Johann Ernst Gunnerus 
Gün.Schneid.	Günther Schneider 
Güner	Adil Güner 
Gürke	Robert Louis August Maximilian Gürke 
Guss.	Giovanni Gussone 
Gus.Schneid.	Gustav Schneider 
Gust.Fisch.	Gustav Fischer 
Guthrie	Francis Guthrie 
Gutw.	Roman Gutwinski 
G.Vidal	Gustav Prosper Vidal 
G.W.Andrews	George W. Andrews 
G.Watt	George Watt 
G.W.Fisch.	George William Fischer 
G.White	Gilbert White 
G.Winter	Heinrich Georg Winter 
G.W.Martin	George Willard Martin 
G.W.Rothwell	Gar W. Rothwell 
G.W.Schimp.	Georg Wilhelm Schimper 
G.Zenker	Georg August Zenker 
G.Zimm.	Gisbert Zimmermann 
Ha	Thi Dung Ha 
Haage	Friedrich Adolph Haage 
H.A.Baker	Hugh Arthur Baker 
Hablitz	Carl Ludwig von Hablitz 
Hack.	Eduard Hackel 
Hacq.	Belsazar Hacquet 
Haeckel	Ernst Haeckel 
Haenke	Thaddäus Haenke 
Häkkinen	Markku Häkkinen 
Halácsy	Eugen von Halácsy 
Haller	Albrecht von Haller 
Haller f.	Albrecht von Haller 
Hallier	Ernst Hans Hallier 
Hallier f.	Johannes Gottfried Hallier 
Ham.	William Hamilton 
Hamel	Gontran Georges Henri Hamel 
H.A.Mill.	Harvey Alfred Miller 
Hampe	Georg Ernst Ludwig Hampe 
Hance	Henry Fletcher Hance 
Hancock	Thomas Hancock 
Hand.-Mazz.	Heinrich Raphael Eduard Handel-Mazzetti 
Hanelt	Peter Hanelt 
Hanes	Clarence Robert Hanes 
Hanry	Hippolyte Hanry 
Hanst.	Johannes Ludwig Emil Robert von Hanstein 
Har.	Paul Auguste Hariot 
Hara	Kanesuke Hara 
Harb.	Thomas Grant Harbison 
Hard	Miron Elisha Hard 
Hardin	James Walker Hardin 
Harkn.	Harvey Willson Harkness 
Harling	Gunnar Wilhelm Harling 
Harms	Hermann Harms 
Hart	Henry Chicester Hart 
Hartig	Theodor Hartig 
Harting	Pieter Harting 
Hartinger	Anton Hartinger 
Hartland	William Baylor Hartland 
Hartm.	Carl Johan Hartman 
Hartw.	Karl Theodor Hartweg 
Hartwig	August Karl Julius Hartwig 
Harv.	William Henry Harvey 
Harvill	Alton McCaleb Harvill, Jr 
Harz	Carl Otto Harz 
Hass	Hagen Hass 
Hassall	Arthur Hill Hassall 
Hässel	Gabriela Gustava Hässel de Menéndez 
Hasselq.	Fredric Hasselquist 
Hasselt	Johan Coenraad van Hasselt 
Hassk.	Justus Carl Hasskarl 
Hassl.	Emil Hassler 
Hatus.	Sumihiko Hatusima 
Haufler	Christopher H. Haufler 
Haught.	Samuel Haughton 
Hauke	Richard L. Hauke 
Hauman	Lucien Leon Hauman 
Hauser	Margit Luise Hauser
Hausskn.	Heinrich Carl Haussknecht 
Hav.	Johan Jonson Havaas 
Havard	Valéry Havard 
Havil.	George Darby Haviland 
Haw.	Adrian Hardy Haworth 
Hayata	Bunzō Hayata 
Hayek	August von Hayek 
Haynald	Cardinal Stephan Franz Lajos 
Hayne	Friedrich Gottlob Hayne 
Haynes	Caroline Coventry Haynes 
Hazsl.	Friedrich August Hazslinszky von Hazslin 
H.Baumann	Helmut Baumann 
H.Blossf.	Harry Blossfeld 
H.B.Matthews	Henry Bleneowe Matthews 
H.Bock	Hieronymus Bock 
H.Bruggen	Heinrich Wilhelm Eduard 
H.B.Ward	Henry Baldwin Ward 
H.C.Beardslee	Henry Curtis Beardslee, Sr. 
H.C.Bold	Harold Charles Bold 
H.D.Clarke	Hugh David Clarke 
H.Deane	Henry Deane 
H.De Orléans	Prince Henri of Orléans 
H.Dietr.	Helga Dietrich 
H.Durand	Hélène Durand 
H.D.Wilson	Hugh Wilson 
H.E.Ahles	Harry E. Ahles 
H.E.Bigelow	Howard E. Bigelow 
Hedberg	Karl Olov Hedberg 
Hedge	Ian Charleson Hedge 
Hedrick	Ulysses Prentiss Hedrick 
Hedw.	Johann 
Heer	Oswald von Heer 
Hegelm.	Christoph Friedrich Hegelmaier 
Hegetschw.	Johannes Jacob Hegetschweiler 
Heim	Georg Christoph Heim 
Heimerl	Anton Heimerl 
Heine	Hermann Heino Heine 
Heinr.	Emil Johann Lambert Heinricher 
Heist.	Lorenz Heister 
Hekking	William Henri Alphonse Maria Hekking 
Heldr.	Theodor Heinrich Hermann von Heldreich 
Hell.	Carl Niclas Hellenius 
Hellq.	Carl Barre Hellquist 
Helms	Richard Helms 
Helwing	George Andreas 
H.E.Moore	Harold Emery Moore 
Hemprich	Wilhelm Hemprich 
Hemsl.	William Botting Hemsley 
Hend.	Edward George Henderson 
Hendel	Johann Christian Hendel 
Hendrych	Radovan Hendrych 
Henfr.	Arthur Henfrey 
Henn.	Paul Christoph Hennings 
Henrard	Johannes Theodoor Henrard 
Henriq	Julio Augusto Henriques 
Henry H.Johnst.	Henry Halcro Johnston 
Hensen	Victor Hensen 
Hensl.	John Stevens Henslow 
Henssen	Aino Marjatta Henssen 
H.E.Petersen	Henning Eiler 
Hepper	Frank Nigel Hepper 
Hepting	George Henry Hepting 
Herb.	William Herbert 
Herder	Ferdinand Gottfried Theobald Herder 
Hérincq	François Hérincq 
Hering	Constantine 
Herklots	Geoffrey Alton Craig Herklots 
Herrm.	Johann Herrmann 
Herter	Wilhelm
Herv.	Alpheus Baker Hervey 
Herzog	Theodor Carl Julius Herzog 
Hesl.-Harr.	John William Heslop-Harrison 
Hesl.-Harr.f.	Jack Heslop-Harrison 
Hess	Johann Jakob Hess 
Hesse	Hermann Albrecht Hesse 
Hett.	Wilbert Hetterscheid 
H.E.White	Harold Everett White 
Hewson	Helen Joan Hewson 
Heybroek	Hans M. Heybroek 
Heynh.	Gustav Heynhold 
Heywood	Vernon Hilton Heywood 
H.F.Comber	Harold Frederick Comber 
H.F.Copel.	Herbert Faulkner Copeland 
H.Fisch.	Hugo Fischer 
H.F.Loomis	H.F. Loomis 
H.Friedrich	Heimo Friedrich 
H.G.Baker	Herbert George Baker 
H.G.P.Duyfjes	Hendrik Gerard Pieter Duyfjes 
H.Groves	Henry Groves 
H.G.Sm.	Henry George Smith 
H.Hara	Hiroshi Hara 
H.H.Blom	Hans Haavardsholm Blom 
H.H.Eaton	Hezekiah Hulbert Eaton 
H.H.Hume	Hardrada Harold Hume 
H.H.Johnst.	Henry "Harry" Hamilton Johnston 
H.H.Lin	Hong Hui Lin 
H.Hoffm.	Heinrich Karl Hermann Hoffmann 
H.Huber	Herbert Franz Josef Huber 
H.H.White	Henry Hoply White 
Hiern	William Philip Hiern 
Hieron.	Georg Hans Emmo Wolfgang Hieronymus 
Hill	John Hill 
Hillebr.	William 
Hilliard	Olive Mary Hilliard 
H.Iltis	Hugo Iltis 
Hinds	Richard Brinsley Hinds 
Hirn	Karl Engelbrecht Hirn 
Hising.	Wilhelm Hisinger 
Hitchc.	Albert Spear Hitchcock 
H.Jacobsen	Hermann Johannes Heinrich Jacobsen 
H.Jaeger	Hermann Jäger 
H.J.Atkins	Hannah Jane Atkins 
H.J.Carter	Herbert James Carter 
H.J.Lam	Herman Johannes Lam 
H.J.Veitch	Harry James Veitch 
H.Karst.	Gustav Karl Wilhelm Hermann Karsten 
H.K.A.Winkl.	Hans Karl Albert Winkler 
H.Keng	Hsüan Keng 
H.Kost.	Henry Koster 
H.Koyama	Hiroshige Koyama 
H.Kurz	Hermann Kurz 
H.K.Walter	Heinrich 
Hladnik	Hugo Leander Blomquist 
H.L.Blomq.	Hugo Leander Blomquist 
H.Lév.	Augustin Abel Hector Léveillé 
H.Limpr.	Hans Wolfgang Limpricht 
H.Lindb.	Harald Lindberg 
H.L.Jacobs	Homer L. Jacobs 
H.L.Li	Hui Lin Li 
H.Lorentz	Hendrik Anton Lorentz 
H.Low	Hugh Low 
H.L.Sm.	Hamilton Lanphere Smith 
H.L.Späth	Hellmut Ludwig Späth 
H.L.Wendl.	Heinrich Ludolph Wendland 
H.Mann	Horace Mann Jr. 
H.Mason	Herbert Louis Mason 
H.M.Curran	Hugh McCullum Curran 
H.M.Hall	Harvey Monroe Hall 
H.Moseley	Henry Nottige Moseley 
H.Müll.	Heinrich Ludwig Hermann Müller 
H.M.Ward	Harry Marshall Ward 
H.N.Andrews	Henry Nathaniel Andrews 
Hnatiuk	Roger James Hnatiuk 
Hobson	Edward Hobson 
Hoch	Peter C. Hoch 
Hochr.	Bénédict Pierre Georges Hochreutiner 
Hochst.	Christian Ferdinand Friedrich Hochstetter 
Hoefker	Heinrich Hoefker 
Høeg	Ove Arbo Høeg 
Hoehne	Frederico Carlos Hoehne 
Hoevel	Otto Hövel 
Hoeven	Jan van der Hoeven 
Hoffm.	Georg Franz Hoffmann 
Hoffmanns.	Johann Centurius von Hoffmannsegg 
Hoffstad	Olaf Alfred Hoffstad 
H.O.Forbes	Henry Ogg Forbes 
Hogg	Thomas Hogg 
H.Ohashi	Hiroyoshi Ohashi 
H.Ohba	Hideaki Ohba 
Hohen.	Rudolph Friedrich Hohenacker 
Höhn.	Franz Xaver Rudolf von Höhnel 
Holland	John Henry Holland 
Hollick	Charles Arthur Hollick 
Holloway	John Ernest Holloway 
Holmb.	Otto Rudolf Holmberg 
Holmes	Edward Morell Holmes 
Holmgren	Hjalmar Josef Holmgren 
Holm-Niels.	Lauritz Broder Holm-Nielsen 
Holmsk.	Johan Theodor Holmskjold 
Holttum	Richard Eric Holttum 
Holub	Josef Ludwig Holub 
Hombr.	Jacques Bernard Hombron 
Honck.	Gerhard August Honckeny 
Honey	Edwin Earle Honey 
Hoogland	Ruurd Dirk Hoogland 
Hook.	William Jackson Hooker 
Hook.f.	Joseph Dalton Hooker 
Hopper	Stephen Hopper 
Hoque	Akramul Hoque 
Horan.	Paul Fedorowitsch Horaninow 
Horik.	Horikawa Yoshiwo 
Horkel	Johann Horkel 
Hornem.	Jens Wilken Hornemann 
Hornsch.	Christian Friedrich Hornschuch 
Horobin	John F. Horobin 
Horsf.	Thomas Horsfield 
Hosaka	Edward Yataro Hosaka 
H.Osborn	Henry Stafford Osborn 
Hosseus	Carl Curt Hosseus 
Host	Nicolaus Thomas Host 
Hough	Romeyn Beck Hough 
Houghton	Arthur Duvernoix Houghton 
House	Homer Doliver House 
Houst.	William Houstoun 
Houtt.	Maarten Houttuyn 
Houtz.	Gysbertus Houtzagers 
Hovel.	Maurice Jean Alexandre Hovelacque 
Howard	John Eliot Howard 
Howe	Eliot Calvin Howe 
Howell	Thomas Jefferson Howell 
H.O.Yates	Harris Oliver Yates 
H.P.Banks	Harlan Parker Banks 
H.Pearson	Henry Harold Welch Pearson 
H.Peng	Hua Peng 
H.Perrier	Joseph Marie Henry Alfred Perrier de la Bâthie 
H.Pfeiff.	Hans Heinrich Pfeiffer 
H.P.Fuchs	Hans Peter Fuchs 
H.Pottinger	Henry Pottinger 
H.Prat	Henri Prat 
H.Rob.	Harold E. Robinson 
H.Rock	Howard Francis Leonard Rock 
H.Rosend.	Henrik Viktor Rosendahl 
H.Schneid.	Harald Schneider 
H.Schott	Heinrich Schott 
H.Sharsm.	Helen Katherine Sharsmith 
H.Shaw	Henry Shaw 
H.Sibth.	Humphry Waldo Sibthorp 
H.S.Irwin	Howard Samuel Irwin 
H.S.Kiu	Hua Shing Kiu 
H.S.Lo	Hsien Shui Lo 
H.Steedman	Henry Steedman 
H.St.John	Harold St. John 
Hu	Hsen Hsu Hu 
Hua	Henri Hua 
Huber	Jacques Huber 
Huds.	William Hudson 
Hue	Auguste-Marie Hue 
Hueber	Francis Maurice Hueber 
Hügel	Karl Alexander Anselm von Hügel 
Hultén	Oskar Eric Gunnar Hultén 
Humb.	Alexander von Humboldt 
Humbert	Jean-Henri Humbert 
Humblot	Léon Humblot 
Hume	Allan Octavian Hume 
Humphries	Christopher John Humphries 
Hunt	George Edward Hunt 
Hunter	Alexander Hunter 
Hunz.	Armando Theodoro Hunziker 
Hürl.	Hans Hürlimann 
Hurus.	Isao Hurusawa 
Hus	Henri Theodore Antoine de Leng Hus 
Husn.	Pierre Tranquille Husnot 
Husseinov	Sch. A. Husseinov 
Hussenot	Louis Cincinnatus Sévérin Léon Hussenot 
Husson	A. M. Husson 
Hust.	Friedrich Hustedt 
Husz	Béla Husz 
Hutch.	John Hutchinson 
Huter	Rupert Huter 
Huth	Ernst Huth 
Hutton	William Hutton 
Huxley	Anthony Julian Huxley 
H.Vilm.	Charles Philippe Henry Lévêque de Vilmorin 
H.V.Hansen	Hans Vilhelm Hansen 
H.W.Clark	Howard Walton Clark 
H.Wendl.	Hermann Wendland 
H.Whitehouse	Harold Leslie Keer Whitehouse 
H.Whittier	Henry O. Whittier 
H.W.Kurz	Holger Willibald Kurz 
H.W.Li	Hsi Wen Li 
H.W.Sarg.	Henry Winthrop Sargent 
Hyl.	Nils Hylander 
H.Y.Su	Ho Yi Su 
I.A.Abbott	Isabella Aiona Abbott 
I.A.Pilát	Ignatz Anton Pilát 
I.Baker	Irene Baker 
I.Bjørnstadt	Inger Nordal 
I.C.Martind.	Isaac Comly Martindale 
I.C.Nielsen	Ivan Christian Nielsen 
I.G.Stone	Ilma Grace Stone 
I.Hagen	Ingebrigt Severin Hagen 
I.I.Abramov	Ivan Ivanovich Abramov 
Iinuma	Yokusai Iinuma 
I.Keller	Ida Augusta Keller 
Ik.Takah.	Ikuro Takahashi 
Iliff	James Iliff 
Iljin	Modest Mikhaĭlovich Iljin 
I.Löw	Immanuel Löw 
Iltis	Hugh Iltis 
Imbach	Emil J. Imbach 
I.M.Johnst.	Ivan Murray Johnston 
I.M.Oliv.	Inge Magdalene Oliver 
I.M.Turner.	Ian Mark Turner 
Immelman	Kathleen Leonore Immelman 
Incarv.	Pierre Nicolas le Chéron 
Ingold	Cecil Terence Ingold 
Ingram	Collingwood Ingram 
Inoue	Inoue Hiroshi 
I.Oliv.	Ian Oliver 
I.Pop	Ioan Pop 
I.Rácz	István Rácz 
Irwin	James Bruce Irwin 
Isaac	Frances Margaret Leighton 
I.Sastre	Ines Sastre 
I.Sinclair	Isabella Sinclair 
I.Sprague	Isaac Sprague 
Ito	Keisuke Ito 
I.Verd.	Inez Clare Verdoorn 
Iversen	Johannes Iversen 
Ives	Joseph Christmas Ives 
I.W.Bailey	Irving Widmer Bailey 
I.W.Hutchison	Isobel Wylie Hutchison 
I.Williams	Ion James Muirhead Williams 
Jack	William Jack 
Jacks.	George Jackson 
J.A.Clark	Josephine Adelaide Clark 
Jacobi	Georg Albano von Jacobi 
Jacobs	Maxwell Ralph Jacobs 
Jacobsen	Hans Jacobsen 
Jacobsson	Stig Jacobsson 
Jacq.	Nikolaus Joseph von Jacquin 
Jacquem.	Venceslas Victor Jacquemont 
Jacques	Henri Antoine Jacques 
Jacquinot	Honoré Jacquinot 
J.Agardh	Jacob Georg Agardh 
J.A.Guim.	José d'Ascensão Guimarães 
Jakubz.	Moisej Markovič Jakubziner 
Jalal	Jeewan Singh Jalal 
Jalas	Arvo Jaakko Juhani Jalas 
Jalink	Leonardo Martinus Jalink 
J.Allam.	Jean-Nicolas-Sébastien Allamand 
J.A.Martind.	Joseph Anthony Martindale 
James	Thomas Potts James 
Jameson	William Jameson 
J.A.Muir	John A. Muir 
Janch.	Erwin Emil Alfred Janchen 
Jancz.	Edward Janczewski 
J.Anderson	James Anderson 
J.Andrews	J. Andrews 
Janka	Victor von Janka 
Janisch.	Dmitrij E. Janischewsky 
Janse	Johannes Albertus Janse 
J.A.Palmer	Julius Auboineau Palmer 
J.A.Schmidt	Johan Anton Schmidt 
Játiva	Carlos D. Játiva 
Jaub.	Hippolyte François Jaubert 
Jáv.	Sándor 
J.Bauhin	Johann Bauhin 
J.B.Comber	James Boughtwood Comber 
J.B.Fisch.	Johann Baptist Fischer 
J.B.Nelson	John B. Nelson 
J.B.Petersen	Johannes Boye Petersen 
J.Bradbury	John Bradbury 
J.Breitenb.	Josef Breitenbach 
J.B.Rohr	Julius Bernard von Röhr 
J.B.Sinclair	James Burton Sinclair 
J.Buchholz	John Theodore Buchholz 
J.Carey	John Carey 
J.C.Clausen	Jens Christen 
J.C.Fisch.	Johann Carl Fischer 
J.C.Gomes	José Corrêa Gomes, Jr. 
J.C.Manning	John Charles Manning 
J.C.Martínez	J. Carlos Martínez Macchiavello 
J.C.Mikan	Johann Christian Mikan 
J.C.Nelson	James Carlton Nelson 
J.Commelijn	Jan Commelin 
J.C.Prag.	Jan C. Prager 
J.C.Ross	James Clark Ross 
J.C.Siqueira	Josafá Carlos de Siqueira 
J.C.Sowerby	James de Carle Sowerby 
J.C.Vogel	Johannes Vogel 
J.C.Wendl.	Johann Christoph Wendland 
J.D.Arm.	James D. Armitage 
J.Dransf.	John Dransfield 
J.D.Ray	James Davis Ray, Jr. 
J.Drumm.	James Drummond 
J.D.Sauer	Jonathan Deininger Sauer 
J.D.Schultze	Johannes Dominik Schultze 
J.E.Alexander	James Edward Alexander 
Jean White	Jean White 
Jebb	Matthew H. P. Jebb 
Jefferies	R.L. Jefferies 
J.E.Gray	John Edward Gray 
Jekyll	Gertrude Jekyll 
J.E.Lange	Jakob Emanuel Lange 
J.Ellis	John Ellis 
J.E.Palmér	Johan Ernst Palmér 
Jeps.	Willis Linn Jepson 
J.E.Sowerby	John Edward Sowerby 
Jess.	Karl Friedrich Wilhelm Jessen 
Jeuken	M. Jeuken 
J.E.Vidal	Jules Eugène Vidal 
J.E.Wright	Jorge Eduardo Wright 
J.E.Zetterst.	Johan Emanuel Zetterstedt 
J.Fabr.	Johan Christian Fabricius 
J.F.Bailey	John Frederick Bailey 
J.F.Clark	Judson Freeman Clark 
J.F.Cowell	John Francis Cowell 
J.F.Gmel.	Johann Friedrich Gmelin 
J.Fisch.	Jacob Benjamin Fischer 
J.-F.Leroy	Jean-François Leroy 
J.F.Macbr.	James Francis Macbride 
J.F.Matthews	James F. Matthews 
J.Forbes	James Forbes 
J.Gay	Jacques Etienne Gay 
J.G.Cooper	James Graham Cooper 
J.Gerard	John Gerard 
J.Gerlach	Justin Gerlach 
J.G.Gmel.	Johann Georg Gmelin 
J.G.Kühn	Julius Gotthelf Kühn 
J.G.Nelson	John Gudgeon Nelson 
J.Gröntved	Julius Gröntved 
J.G.Sm.	Jared Gage Smith 
J.G.West	Judith Gay West 
J.H.Adam	Jumaat Haji Adam 
J.Harriman	John Harriman 
J.H.Kirkbr.	Joseph Harold Kirkbride 
J.Hogg	John Hogg 
J.Houz.	Jean Houzeau de Lehaie 
J.H.Wallace	John Hume Wallace 
J.H.Willis	James Hamlyn Willis 
Jílek	Bohumil Jílek 
J.Jacobsen	Jens Peter Jacobsen 
J.J.Amann	Jean Jules Amann 
J.J.Engel	John Jay Engel 
J.J.Kickx	Jean Jacques Kickx 
J.J.Scheuchzer	Johann Jacob Scheuchzer 
J.J.Sm.	Johannes Jacobus Smith 
J.Jundz.	Józef Jundzill 
J.Juss.	Joseph de Jussieu 
J.J.Verm.	Jaap J. Vermeulen 
J.K.Bartlett	John Kenneth Bartlett 
J.Kern	Johannes Hendrikus Kern 
J.Kickx	Jean Kickx, Sr. 
J.Kickx f.	Jean Kickx, Jr. 
J.K.Morton	John Kenneth Morton 
J.Koenig	Johann Gerhard Koenig 
J.K.Towns.	John Kirk Townsend 
J.Lachm.	Johannes Lachmann 
J.L.Clark	John Littner Clark 
J.Lee	James Lee 
J.Léonard	Jean Joseph Gustave Léonard 
J.L.Gentry	Johnnie Lee Gentry 
J.Lowe	Josiah Lincoln Lowe 
J.L.Palmer	Johann Ludwig Palmer 
J.L.Schultz	Joanna L. Schultz 
J.MacGill.	John MacGillivray 
J.Macrae	James Macrae 
J.Martyn	John Martyn 
J.M.Bigelow	John Milton Bigelow 
J.M.Black	John McConnell Black 
J.M.Clarke	John Mason Clarke 
J.M.Coult.	John Merle Coulter 
J.M.C.Rich.	Jean Michel Claude Richard 
J.M.MacDougal	John Mochrie MacDougal 
J.M.Muñoz	Jesús M. Muñoz 
J.M.Schopf	James Morton Schopf 
J.Muir	John Muir 
J.Muñoz	Jesús Muñoz 
J.Murray	John Murray 
J.M.Waller	James Martin Waller 
J.M.Webber	John Milton Webber 
J.M.Wood	John Medley Wood 
Jn.Dalton	John Dalton 
Johan-Olsen	Olav Johan Sopp 
Johanss.	Karl Johansson 
John Muir	John Muir 
John Parkinson	John Parkinson 
Johnst.	George Johnston 
Johow	Federico Johow 
Jongkind	Carel Christiaan Hugo Jongkind 
Jonst.	John Jonston 
Jord.	Claude Thomas Alexis Jordan 
Jos.Kern.	Josef Kerner 
Jos.Martin	Joseph Martin 
J.Ott	Jonathan Ott 
Jovet	Paul Albert Jovet 
J.Palmer	Joanne Palmer 
J.P.Anderson	Jacob Peter Anderson 
J.Parn.	John Adrian Naicker Parnell 
J.Pfeiff.	Johan Philip Pfeiffer 
J.P.Nelson	Jane P. Nelson 
J.Poiss.	Jules Poisson 
J.Prado	Jefferson Prado 
J.Presl	Jan Svatopluk Presl 
J.Raynal	Jean Raynal 
J.R.Clarkson	John Richard Clarkson 
J.Rémy	Ezechiel Jules Rémy 
J.R.Forst.	Johann Reinhold Forster 
J.R.Lee	John Ramsay Lee 
J.Roth	Johannes Rudolph Roth 
J.Roux	Jean Roux 
J.R.Perkins	John Russell Perkins 
J.Scheff.	Jozef Scheffer 
J.Scheuchzer	Johannes Gaspar Scheuchzer 
J.Schiller	Josef Schiller 
J.Schneid.	Josef Schneider 
J.Schröt.	Joseph Schröter 
J.Schultze-Motel	Jürgen Schultze-Motel 
J.Scott	John Scott 
J.Scriba	Julius Karl Scriba 
J.Sinclair	James Sinclair 
J.Sm.	John Smith 
J.S.Martin	James Stillman Martin 
J.Soulié	Jean André Soulié 
J.S.Pringle	James Scott Pringle 
J.St.-Hil.	Jean Henri Jaume Saint-Hilaire 
J.T.Curtis	John Thomas Curtis 
J.T.Howell	John Thomas Howell 
J.T.Palmer	James Terence Palmer 
J.T.Pan	Jin Tang Pan 
J.T.Pereira	Joan T. Pereira 
J.T.Quekett	John Thomas Quekett 
J.T.Wall	J. T. Wall 
J.T.Waterh.	John Teast Waterhouse 
Judd	Walter Stephen Judd 
Jum.	Henri Lucien Jumelle 
Jungh.	
Junius	Hadrianus Junius 
Juss.	Antoine Laurent de Jussieu 
Juz.	Sergei Vasilievich Juzepczuk 
J.V.Lamour.	Jean Vincent Félix Lamouroux 
J.V.Schneid.	Julio Valentin Schneider 
J.V.Thomps.	John Vaughan Thompson 
J.Wallis	John Wallis 
J.W.Benn.	John Whitchurch Bennett 
J.W.Cribb	Joan Winifred Cribb 
J.Wen	Jun Wen 
J.West	James West 
J.W.Green	John William Green 
J.White R.N.	John White 
J.W.Mast.	John William Masters 
J.Woods	Joseph Woods Jr. 
J.W.Powell	John Wesley Powell 
J.W.Robbins	James Watson Robbins 
J.W.Weinm.	Johann Wilhelm Weinmann 
J.W.White	James Walter White 
J.W.Zetterst.	Johan Wilhelm Zetterstedt 
J.Zahlbr.	Johann Zahlbruckner 
Kablík.	Josephine Ettel Kablick 
Kache	Paul Kache 
Kaempf.	Engelbert Kaempfer 
Kai Müll.	Kai Müller 
Kalchbr.	Károly Kalchbrenner 
Kalkman	Cornelis Kalkman 
Kallenb.	Franz Joseph Kallenbach 
Kalm	Pehr Kalm 
Kaltenb.	Johann Heinrich Kaltenbach 
Kamel	Georg Joseph Kamel 
Kamelin	Rudolf V. Kamelin 
Kamieński	Franciszek Michailow von Kamieński 
Kanai	Hiroo Kanai 
Kanda	Hiroshi Kanda 
Kane	Katharine Sophia Bailey Kane 
Kaneh.	Ryōzō Kanehira 
Kanér	Oskar Richard Kanér 
Kanes	William H. Kanes 
Kanis	Andrias Kanis 
Kanitz	August Kanitz 
Kanjilal	Upendranath Kanjilal 
Kann	Edith Kann 
Kanouse	Bessie Bernice Kanouse 
Kantsch.	Zaiharias A. Kantschaweli 
Kantvilas	Ginteras Kantvilas 
Kappl.	August Kappler 
Kartesz	John T. Kartesz 
Kasper	Andrew Edward Kasper 
Kaul	Kailash Nath Kaul 
Kaulf.	Georg Friedrich Kaulfuss 
Kavina	Karel Kavina 
Kaz.Osaloo	Shahrokh Kazempour Osaloo 
K.Bergius	Karl Heinrich Bergius 
K.Brandegee	Mary Katharine Brandegee 
K.Brandt	Andreas Heinrich Karl Brandt 
K.Bremer	Kåre Bremer 
K.D.Hill	Kenneth D. Hill 
K.D.Koenig	Charles 
Kearney	Thomas Henry Kearney 
Keating	William Hippolitus 
Keck	Karl Keck 
Keener	Carl Samuel Keener 
Keighery	Gregory John Keighery 
Keissl.	Karl von Keissler 
Kellerm.	William Ashbrook Kellerman 
Kellogg	Albert Kellogg 
Kelly	Howard Atwood Kelly 
Kemmler	Carl Albert Kemmler 
Keng	Yi Li Keng 
Keng f.	Pai Chieh Keng 
Kenrick	Paul Kenrick 
Kent	William Saville-Kent 
Ker	Charles Henry Bellenden Ker 
Keraudren	Monique Keraudren 
Kerch.	Oswald Charles Eugène Marie Ghislain de Kerchove de Denterghem 
Kereszty	Zoltán Kereszty 
Ker Gawl.	John Bellenden Ker Gawler 
Kerguélen	Michel François-Jacques Kerguélen 
Kerr	Arthur Francis George Kerr 
Kers	Lars Erik Kers 
Kerst.	Otto Kersten 
Keyserl.	Alexander Friedrich Michael Leberecht Arthur von Keyserling 
K.F.R.Schneid.	Karl Friedrich Robert Schneider 
K.F.Schimp.	Karl Friedrich Schimper 
K.Hammer	Karl Hammer 
Khawkine	Mardochée-Woldemar Khawkine 
K.Heyne	Karel Heyne 
K.Hoffm.	Käthe Hoffmann 
Khoon	Meng Wong Khoon 
K.I.Chr.	Knud Ib Christensen 
Kidst.	Robert Kidston 
Kiew	Ruth Kiew 
Kiggel.	Franz 
K.I.Goebel	Karl Ritter von Goebel 
Killias	Eduard Killias 
Killip	Ellsworth Paine Killip 
Kindb.	Nils Conrad Kindberg 
Kindt	Christian Sommer Kindt 
King	George King 
Kingdon-Ward	Frank Kingdon-Ward 
Kirby	Mary Kirby 
Kirchn.	Emil Otto Oskar von Kirchner 
Kirk	Thomas Kirk 
Kirschl.	Frédéric Kirschleger 
Kirschst.	Wilhelm Kirschstein 
Kit.	Pál Kitaibel 
Kitag.	Masao Kitagawa 
Kitt.	Martin Baldwin Kittel 
Kittlitz	Friedrich Heinrich von Kittlitz 
Kit Tan	Kit Tan 
Kjellm.	Frans Reinhold Kjellman 
K.Jess.	Knud Jessen 
K.J.Kim	Ki Joong Kim 
K.J.Martin	Kenneth J. Martin 
K.Koch	Karl Heinrich Emil Koch 
K.Komatsu	Katsuko Komatsu 
K.Krause	Kurt Krause 
K.Kurtz	Karl Marie Max Kurtz 
K.Larsen	Kai Larsen 
Klatt	Friedrich Wilhelm Klatt 
Klein	Jacob Theodor Klein 
Klotzsch	Johann Friedrich Klotzsch 
K.M.Drew	Kathleen Mary Drew-Baker 
K.M.Feng	Kuo Mei Feng 
K.M.Matthew	Koyapillil Mathai Matthew 
K.Möbius	Karl Möbius 
K.M.Purohit	K. M. Purohit 
K.Müll.	Konrad Müller 
K.M.Wong	Khoon Meng Wong 
Knapp	John Leonard Knapp 
Knebel	Gottfried Knebel 
Kneuck.	Johann Andreas Kneucker 
Knight	Joseph Knight 
Knobl.	Emil Friedrich Knoblauch 
Knuth	Paul Knuth 
Kny	Carl Ignaz Leopold Kny 
Kobuski	Clarence Emmeren Kobuski 
Koch	Johann Friedrich Wilhelm Koch 
Kochummen	Kizhakkedathu Mathai Kochummen 
Koehne	Bernhard Adalbert Emil Koehne 
Koeler	Georg Ludwig Koeler 
Koell.	Rudolf Albert von Koelliker 
Koelle	Johann Ludwig Christian Koelle 
Koidz.	Gen-ichi Koidzumi 
Kolen.	Friedrich August 
Kom.	Vladimir Leontyevich Komarov 
Komiya	Sadashi Komiya 
Koopmann	Karl Koopmann 
Koord.	Sijfert Hendrik Koorders 
Koord.-Schum.	Anna Koorders-Schumacher 
Kops	Jan Kops 
Körb.	Gustav Wilhelm Körber 
Kôriba	Kwan Kôriba 
Körn.	Friedrich August Körnicke 
Kornh.	
Korol.	Valentina Alekseevna Koroleva, also Valentina Alekseevna Koroleva-Pavlova 
Körte	Heinrich Friedrich Franz Körte 
Korth.	Pieter Willem Korthals 
K.Osada	Keigo Osada 
Kosterm.	André Joseph Guillaume Henri Kostermans 
Kotl.	František Kotlaba 
Kotov	Mikhail Ivanovich Kotov 
Kotschy	Carl Georg Theodor Kotschy 
Kotyk	Michele E. Kotyk 
K.Prasad	Kothareddy Prasad 
Kraenzl.	Friedrich Wilhelm Ludwig Kraenzlin 
Krajina	Vladimir Joseph Krajina 
Kral	Robert Kral 
Kralik	Jean-Louis Kralik 
Krapov.	Antonio Krapovickas 
Krasn.	Andrej Nikovaevich Krassnov 
Kraus	Gregor Konrad Michael Kraus 
Krause	Johann Wilhelm Krause 
Kräusel	Richard Oswald Karl Kräusel 
Krebs	Georg Ludwig Engelhard Krebs 
Kremp.	August von Krempelhuber 
Kreutz	Carolus Adrianus Johannes Kreutz 
Kreuz.	Kurt Kreuzinger 
K.Richt.	Karl Richter 
Krock.	Anton Johann Krocker 
Krok	Thorgny Ossian Bolivar Napoleon Krok 
Krombh.	Julius Vincenz von Krombholz 
K.R.Robertson	Kenneth R. Robertson 
Krug	Karl 
Krüssm.	Johann Gerd Krüssmann 
K.Schum.	Karl Moritz Schumann 
K.S.Prasad	Karuvankoodelu Subrahmanya Prasad 
Kubitzki	Klaus Kubitzki 
Kudô	Yûshun Kudô 
Kuhlm.	João Geraldo Kuhlmann 
Kuhn	Friedrich Adalbert Maximilian Kuhn 
Kuijt	Job Kuijt 
Kük.	Georg Kükenthal 
Kumar	Pankaj Kumar 
Kunth	Carl Sigismund Kunth 
Kuntze	Carl Ernst Otto Kuntze 
Kunze	Gustav Kunze 
Kupicha	Frances Kristina Kupicha 
Kuprian.	Ludmila Kuprianova 
Kurata	S. Kurata 
Kurbanb.	Z. K. Kurbanbekov 
Kurbanov	D. K. Kurbanov 
Kurbatski	Vladimir Ivanovich Kurbatski 
Kurczenko	Elena Ivanovna Kurczenko 
Kurib.	Kazue Kuribayashi 
Kurita	Siro Kurita 
Kurkiev	Uolubii Kishtishevich Kurkiev 
Kurl.	Boguslav Stanislavovich Kurlovich 
Kurogi	Munengo Kurogi 
Kurok.	Syo Kurokawa 
Kurr	Johann Gottlieb von Kurr 
Kürschner	Harald Kürschner 
Kurtto	Arto Kurtto 
Kurtz	Fritz 
Kurtzman	Cletus P. Kurtzman 
Kurz	Wilhelm Sulpiz Kurz 
Kurzweil	Hubert Kurzweil 
Küster	Ernst Küster 
Kuswata	E. Kuswata Kartawinata 
Kütz.	Friedrich Traugott Kützing 
K.Wilh.	Karl Adolf Wilhelm 
K.Y.Pan	Kai Yu Pan 
L.	Carl Linnaeus
Carolus Linnæus	Carl Linnaeus
Lin	Carl Linnaeus
Linn	Carl Linnaeus
Linné	Carl Linnaeus
Labill.	Jacques Labillardière 
Lacaita	Charles Carmichael Lacaita 
Lace	John Henry Lace 
La Duke	John C. La Duke 
Laest.	Lars Levi Læstadius 
Laferr.	Joseph E. Laferrière 
Lag.	Mariano Lagasca y Segura 
Lagerh.	Nils Gustaf von Lagerheim 
Lakela	Olga Korhoven Lakela 
La Llave	Pablo de La Llave 
L.Allorge	Lucile Allorge 
Lam.	Jean-Baptiste Lamarck 
Lamb.	Aylmer Bourke Lambert 
Lamy	Pierre Marie Édouard Lamy de la Chapelle 
Lancaster	Roy Lancaster 
Lander	Nicholas Sèan Lander 
L.Andersson	Bengt Lennart Andersson 
Landolt	Elias Landolt 
Landrum	Leslie R. Landrum 
Lane-Poole	Charles Edward Lane-Poole 
Lange	Johan Martin Christian Lange 
Langeron	Maurice Charles Pierre Langeron 
Langeth.	Christian Eduard Langethal 
Langsd.	Georg Heinrich von Langsdorff 
Lank.	E. Ray Lankester 
Lantz.-Bén.	Georg Boyung Scato Lantzius-Béninga 
Lapeyr.	Baron Philippe-Isidore Picot de Lapeyrouse 
Lapham	Increase Allen Lapham 
L.A.S.Johnson	Lawrence Alexander Sidney Johnson 
Lasser	Tobías Lasser 
Latap.	François-de-Paule Latapie 
Laterr.	Jean François Laterrade 
Lat.-Marl.	Joseph Bory Latour-Marliac 
Latourr.	Marc Antoine Louis Claret de La Tourrette 
Lauterb.	Carl Adolf Georg Lauterbach 
Lauterborn	Robert Lauterborn 
Lauz.-March.	Marguerite Lauzac-Marchal 
Lavallée	Pierre Alphonse Martin Lavallée 
Lavrent.	Georgios Lavrentiades 
Lawalrée	André Gilles Célestin Lawalrée 
Lawrance	Mary Lawrance 
Lawson	George Lawson 
Laxm.	Erich G. Laxmann 
Layens	Georges de Layens 
Laz.	Andrei Sazontovich Lazarenko 
L.Bolus	Harriet Margaret Louisa Bolus 
L.Borgen	Liv Borgen 
L.B.Sm.	Lyman Bradford Smith 
L.Clark	Lois Clark 
L.C.Leach	Leslie Charles Leach 
L.C.Wheeler	Louis Cutter Wheeler 
L.D.Gómez	Luis Diego Gómez 
L.D.Pryor	Lindsay Pryor 
Leandri	Jacques Désiré Leandri 
Leav.	Robert Greenleaf Leavitt 
Leavenw.	Melines Conklin Leavenworth 
Lecomte	Paul Henri Lecomte 
Leconte	John 
Lecoq	Henri Lecoq 
Ledeb.	Carl Friedrich von Ledebour 
Leefe	John Ewbank Leefe 
Leeke	Georg Gustav Paul Leeke 
Leenh.	Pieter Willem Leenhouts 
Leers	Johann Georg Daniel Leers 
Lees	Edwin Lees 
Leeuwenb.	Anthonius Josephus Maria Leeuwenberg 
Lehm.	Johann Georg Christian Lehmann 
Lehnebach	Carlos Adolfo Lehnebach 
Leibold	Friedrich Ernst Leibold 
Leight.	William Allport Leighton 
Leitg.	Hubert Leitgeb 
Leitn.	Edward Frederick Leitner 
Lej.	Alexandre Louis Simon Lejeune 
Le Jol.	Auguste François le Jolis 
Lellinger	David B. Lellinger 
Lelong	Michel G. Lelong 
Lem.	Charles Antoine Lemaire 
Le Maout	Jean Emmanuel Maurice Le Maout 
Lemmerm.	Ernst Johann Lemmermann 
Lemmon	John Gill Lemmon 
Lemoine	
Le Monn.	Louis Guillaume Le Monnier 
L.E.Navas	Luisa Eugenia Navas 
Lenorm.	Sébastien René Lenormand 
León	Frère León 
Leonard	Emery Clarence Leonard 
Lepr.	François Mathias René Leprieur 
L.E.Rodin	Leonid Efimovich Rodin 
Leroy	Andre Leroy 
Les	Donald H. Les 
Lesch.	Jean Baptiste Leschenault de la Tour 
L.E.Skog	Laurence Edgar Skog 
Lesq.	Charles Léo Lesquereux 
Less.	Christian Friedrich Lessing 
Lév.	Joseph-Henri Léveillé 
Levyns	Margaret Rutherford Bryan Levyns 
Lewin	Ralph Arnold Lewin 
Lewis	Meriwether Lewis 
Lex.	Juan José Martinez de Lexarza 
Leyb.	Friedrich Leybold 
Leyss.	Friedrich Wilhelm von Leysser 
L.f.	Carolus Linnaeus the Younger 
L.F.Hend.	Louis Forniquet Henderson 
L.Fisch.	Ludvig Fischer 
L.Fuchs	Leonhart Fuchs 
L.G.Clark	Lynn G. Clark 
L.H.Bailey	Liberty Hyde Bailey 
L.H.Dewey	Lyster Hoxie Dewey 
L.Henry	Louis Henry 
L'Hér.	Charles Louis L'Héritier de Brutelle 
L.H.Gray	Louis Harold Gray 
L.Höhn.	Ludwig von Höhnel 
Liais	Emmanuel Liais 
Lib.	Marie-Anne Libert 
Libosch.	Joseph Liboschitz 
L.I.Cabrera	Lidia Irene Cabrera 
Licht.	Martin Lichtenstein 
Lidén	Magnus Lidén 
Liebl.	Franz Kaspar 
Liebm.	Frederik Michael Liebmann 
Lightf.	John Lightfoot FRS 
Lilj.	Samuel Liljeblad 
Limpr.	Karl Gustav Limpricht 
Lindau	Gustav Lindau 
Lindb.	Sextus Otto Lindberg 
Linden	Jean Jules Linden 
Lindenb.	Johann Bernhard Wilhelm Lindenberg 
Lindl.	John Lindley 
Lindm.	Carl Axel Magnus Lindman 
Lindq.	Sven Bertil Gunvald Lindquist 
Lingelsh.	Alexander von Lingelsheim 
Link	Johann Heinrich Friedrich Link 
Linsbauer	Karl Linsbauer 
Linton	William James Linton 
Lippold	Hans Lippold 
Lipsky	Vladimir Ippolitovich Lipsky 
L.I.Savicz	Lydia Ivanovna Savicz-Lubitskaya 
Litard.	René Verriet de Litardière 
Little	Elbert Luther Little 
Litv.	Dmitrij Ivanovitsch Litvinov 
Livingst.	C. Livingstone 
L.J.Davenp.	Lawrence James Davenport 
L.K.Fu	Li-kuo Fu 
Llanos	Antonio Llanos 
L.L.Daniel	Lucien Louis Daniel 
L.M.Ames	Lawrence Marion Ames 
L.Martin	Lucille Martin 
L.McCulloch	Lucia McCulloch 
L.M.Perry	Lily May Perry 
L.M.Vidal	Luis Mariano Vidal 
L.Nutt.	Lawrence William Nuttall 
Lobel	Matthias de l'Obel 
Lodd.	Joachim Conrad Loddiges 
Loefl.	Pehr Loefling 
Loes.	Ludwig Eduard Theodor Loesener 
Loeske	Leopold Loeske 
Loisel.	Jean-Louis-Auguste Loiseleur-Deslongchamps 
Lojac.	Michele Lojacono 
Lombardi	Julio Antonio Lombardi 
Longyear	Burton Orange Longyear 
Lonitzer	Adam Lonicer 
Lönnrot	Elias Lönnrot 
Loosjes	Adriaan Loosjes 
Lorch	Wilhelm Lorch 
Lord	Ernest E. Lord 
Lorentz	Paul Günther Lorentz 
Loschnigg	Vilim Loschnigg 
Losinsk.	A.S. Losina-Losinskaja 
Lothian	Thomas Robert Noel Lothian 
Lotsy	Johannes Paulus Lotsy 
Lott	Henry J. Lott 
Loudon	John Claudius Loudon 
Lounsb.	Alice Lounsberry 
Lour.	João de Loureiro 
Lourteig	Alicia Lourteig 
Lowe	Richard Thomas Lowe 
L.O.Williams	Louis Otho Williams 
Lowrie	Allen Lowrie 
Lowry	Porter Prescott Lowry 
Lozano	Gustavo Lozano-Contreras 
L.Planch.	Louis David Planchon 
L.Post	Ernst Jakob 
L.Preiss	Ludwig Preiss 
L.R.Blinks	Lawrence Rogers Blinks 
L.R.Jones	Lewis Ralph Jones 
L.Schneid.	Eduard Karl Ludwig Schneider 
L.Späth	Louis Späth 
L.S.Sm.	Lindsay Stewart Smith 
L.T.Lu	Ling Ti Lu 
Lucand	Jean Louis Lucand 
Luces	Zoraida Luces de Febres 
Ludlow	Frank Ludlow 
Luer	Carlyle A. Luer 
Luetzelb.	Philipp von Luetzelburg 
Lundell	Cyrus Longworth Lundell 
Lundin	Roger Lundin 
Lunell	Joël Lunell 
Lush.	Alfred Wyndham Lushington 
Lüth	Michael Lüth 
Lütjeh.	Wilhelm Jan Lütjeharms 
Lutz	Berta Maria Júlia Lutz 
L.W.Lenz	Lee Wayne Lenz 
Lý	Trân Ðinh Lý 
Lyall	David Lyall 
Lydgate	John Mortimer Lydgate 
Lye	Kaare Arnstein Lye 
Lyell	Charles Lyell 
Lyons	Israel Lyons 
Ma	Yu Chuan Ma 
Maack	Richard Karlovich Maack 
Maas	Paul Maas 
Maas Geest.	Rudolph Arnold Maas Geesteranus 
M.A.Baker	Marc A. Baker 
Mabb.	David Mabberley 
Mabry	Tom J. Mabry 
MacDan.	Laurence Howland MacDaniels 
Macfarl.	John Muirhead Macfarlane 
Machado	Othon Xavier de Brito Machado 
Mack.	Kenneth Kent Mackenzie 
Macklot	Heinrich Christian Macklot 
M.A.Clem.	Mark Alwin Clements 
MacMill.	Conway MacMillan 
Macoun	John Macoun 
MacOwan	Peter MacOwan 
M.A.Curtis	Moses Ashley Curtis 
Madani	Leopold Madani 
Madenis	Claude Benoit Madenis 
Madhus.	P. V. Madhusoodanam 
M.A.Diniz	Maria Adélia Diniz 
Madison	Michael T. Madison 
M.A.Dix	Margaret A. Dix 
Mädler	Karl Mädler 
Madore	Lois Kay Madore 
Madrigal	Xavier Madrigal-Sánchez 
Madriñán	Santiago Madriñán 
Madsen	Jens E. Madsen 
M.A.Fenton	Mildred Adams Fenton 
M.A.Fisch.	Manfred A. Fischer 
Mägd.	Karl Mägdefrau 
Magill	Robert Earle Magill 
Magnin	Antoine Magnin 
Magnol	Pierre Magnol 
Magnus	Paul Wilhelm Magnus 
Maguire	Bassett Maguire 
Mai	Dieter Hans Mai 
Maiden	Joseph Maiden 
Maille	Alphonse Maille 
Maingay	Alexander Carroll Maingay 
Maire	René Maire 
Maitul.	Yulia Konstantinovna Maitulina 
Makino	Tomitaro Makino 
Malaisse	François Malaisse 
Malbr.	Alexandre François Malbranche 
M.Allemão	Manoel Allemão 
Malm	Jacob von Malm 
Malme	Gustaf Oskar Andersson Malme 
Malmgren	Anders Johan Malmgren 
Mandon	Gilbert 
Manik.	U. Manikandan 
Manilal	Kattungal Subramaniam Manilal 
M.A.N.Müll.	Michiel Adriaan Niklaas Müller 
Mansf.	Rudolf Mansfeld 
Manton	Irene Manton 
Mappus	Marcus Mappus 
Marais	Wessel Marais 
Maranta	Bartolomeo Maranta 
Marcgr.	Georg Marcgrave 
Marchal	Élie Marchal 
Marchand	Nestor Léon Marchand 
Marchesi	Eduardo Marchesi 
Marchoux	Émile Marchoux 
Marcks	Brian Marcks 
Marg.	Hanna Bogna Margońska 
Margulis	Lynn Margulis 
Marion	Antoine Fortuné Marion 
Markgr.	Friedrich Markgraf 
Markgr.-Dann.	Ingeborg Markgraf-Dannenberg 
Markham	Clements Robert Markham 
Marloth	Hermann Wilhelm Rudolf Marloth 
Marnock	Robert Marnock 
Marquand	Ernest David Marquand 
Marquis	Alexandre Louis Marquis 
Marrero Rodr.	Águedo Marrero Rodriguez 
Marriott	Neil Marriott 
Marroq.	Jorge S. Marroquín 
Marsh	Charles Dwight Marsh 
Marshall	Humphry Marshall 
Mart.	Carl Friedrich Philipp von Martius 
Mart.-Azorín	Mario Martínez-Azorín 
Mart.Crov.	Raul Martinez Crovetto 
Martelli	Ugolino Martelli 
Mårtensson	Olle Mårtensson 
Mart.Flores	Fernando Martínez Flores 
Martín Bol.	Manuel Martín Bolaños 
Martín-Bravo	Santiago Martín-Bravo 
Martinelli	Gustavo Martinelli 
Martinet	Jean Baptiste Henri Martinet 
Martínez	Maximino Martínez 
Martini	Alessandro Martini 
Martinoli	Giuseppe Martinoli 
Martinov	Ivan Ivanovich Martynov 
Martinovský	Jan Otakar Martinovský 
Martins	Charles Frédéric Martins 
Mart.-Laborde	Juan Batista Martínez-Laborde 
Mart.Mart.	M. Martínez Martínez 
Mart.Parras	José María Martinez Parras 
Martrin-Donos	Julien Victor de Martrin-Donos 
Mart.Schmid	Martin Schmid 
Martyn	Thomas M. Martyn 
Masam.	Genkei Masamune 
Massee	George Edward Massee 
Masson	Francis Masson 
Mast.	Maxwell Tylden Masters 
Mateo	Gonzalo Mateo 
Mathias	Mildred Esther Mathias 
Mathieu	Charles Marie Joseph Mathieu 
Matr.	Alphonse Louis Paul Matruchot 
Matsum.	Jinzô Matsumura 
Matt.	Heinrich Gottfried von Mattuschka 
Mattei	Giovanni Ettore Mattei 
Matteri	Celina Maria Matteri 
Mattf.	Johannes Mattfeld 
Matthäs	Ursula Matthäs 
Matthei	Oscar R. Matthei 
Matthew	George Frederick Matthew 
Matthews	Henry John Matthews 
Matthiesen	Franz Matthiesen 
Mattick	Wilhelm Fritz Mattick 
Mattioli	Pietro 
Mattir.	Oreste Mattirolo 
Mattos	Joáo Rodrigues de Mattos 
Mattox	Karl R. Mattox 
Matuda	Eizi Matuda 
Maund	Benjamin Maund 
M.A.Wall	M. A. Wall 
Maxim.	Carl Maximowicz 
Maxon	William Ralph Maxon 
Maxwell	T.C.Maxwell 
M.Backlund	Maria Backlund 
M.Bieb.	Friedrich August Marschall von Bieberstein 
M.Blackw.	Meredith Blackwell 
M.Broun	Maurice Broun 
M.B.Schwarz	Marie Beatrice Schol-Schwarz 
M.B.Scott	Munro Briggs Scott 
M.B.Viswan.	M. B. Viswanathan 
M.Caball.	Miguel Caballero Deloya 
McAll.	Hugh A. McAllister 
M.Catal.	Marcello Catalano 
M.C.Chang	Mei Chen Chang 
M.C.Ferguson	Margaret Clay Ferguson 
McClell.	John McClelland 
McClure	Floyd Alonzo McClure 
McCord	David Ross McCord 
McCormick	Robert McCormick 
McCoy	Frederick McCoy 
McDonald	William H. McDonald 
M.C.E.Amaral	Maria do Carmo Estanislau do Amaral 
McGill.	Donald McGillivray 
McGregor	Ronald Leighton McGregor 
McIlv.	Charles McIlvaine 
M.C.Johnst.	Marshall Conring Johnston 
McKinney	Harold Hall McKinney 
M.C.Martínez	María Cristina Martínez 
McMillan	A.J.S. McMillan 
McNeill	John McNeill 
McVaugh	Rogers McVaugh 
M.D.Correa	Mireya D. Correa A. 
M.D.Hend.	Mayda Doris Henderson 
Medik.	Friedrich Kasimir Medikus 
Medlicott	Henry Benedict Medlicott 
Meehan	Thomas Meehan 
Meenks	Jan L. D. Meenks 
Meerb.	Nicolaas Meerburgh 
Meerow	Alan W. Meerow 
Meier	Fred Campbell Meier 
Meigen	Johann Wilhelm Meigen 
Meijden	Ruud van der Meijden 
Meijer	Willem Meijer 
Meikle	Robert Desmond Meikle 
Meinecke	Johann Ludwig Georg Meinecke 
Meins	Claus Meins 
Meinsh.	Karl Friedrich Meinshausen 
Meisel	Max Meisel 
Meisn.	Carl Daniel Friedrich Meissner 
M.E.Jones	Marcus Eugene Jones 
Melch.	Hans Melchior 
Melikyan	Aleksander Pavlovich Melikyan 
Melville	Ronald Melville 
Melvin	Norman C. Melvin, III 
Mendel	Gregor Mendel 
Mendonça	Francisco de Ascencão Mendonça 
Mend.-Heuer	Ilse R. Mendoza-Heuer 
Menezes	Carlos Azevedo de Menezes 
Menge	Franz Anton Menge 
Mennega	Alberta Maria Wilhelmina Mennega 
Mentz	August Mentz 
Menyh.	László Menyhárth 
Menzel	Paul Julius Menzel 
Menzies	Archibald Menzies 
Mérat	François Victor Mérat de Vaumartoise 
Mereschk.	Konstantin Mereshkovski 
Merr.	Elmer Drew Merrill 
Merriam	Clinton Hart Merriam 
Mert.	Franz Carl Mertens 
Merxm.	Hermann Merxmüller 
Mesnil	Félix Étienne Pierre Mesnil 
Mett.	Georg Heinrich Mettenius 
Metzg.	Johann Metzger 
Mey.-Berth.	Brigitte Meyer-Berthaud 
Meyen	Franz Julius Ferdinand Meyen 
Mez	Carl Christian Mez 
M.F.Bourdon	M. F. Bourdon 
M.F.Fay	Michael Francis Fay 
M.Fleisch.	Max Fleischer 
M.G.Brooks	Maurice Graham Brooks 
M.G.Calder	Mary Gordon Calder 
M.G.Henry	Mary Gibson Henry 
M.Gómez	Manuel Gómez de la Maya y Jiménez 
M.Hiroe	Minosuke Hiroe 
M.Hopkins	Milton Hopkins 
M.Hotta	Mitsuru Hotta 
M.Howe	Marshall Avery Howe 
Micevski	Kiril Micevski 
Michaelis	Peter Michaelis 
Micheli	Marc Micheli 
Michelis	Friedrich Bernhard 
Mich.Möller	Michael Möller 
Michon	Jean-Hippolyte Michon 
Michx.	André Michaux 
Middend.	Alexander von Middendorff 
Middled.	Harry Middleditch 
Miers	John Miers 
Mig.	Emil Friedrich August Walter 
Migo	Hisao Migo 
Mik	Josef 
Mikl.-Maclay	Nikolaj Nikolajewitsch Miklouho-Maclay 
Mildbr.	Johannes Mildbraed 
Milde	Carl August Julius Milde 
Mill.	Philip Miller 
Millais	John Guille Millais 
Millardet	Pierre-Marie-Alexis Millardet 
Millsp.	Charles Frederick Millspaugh 
Milne	Colin Milne 
Milne-Edw.	Alphonse Milne-Edwards 
Milne-Redh.	Edgar Wolston Bertram Handsley Milne-Redhead 
Miq.	Friedrich Anton Wilhelm Miquel 
Miranda	Faustino Miranda 
Mirb.	Charles-François Brisseau de Mirbel 
Mirzoeva	Nina Vasilevna Mirzoeva 
Mitch.	John Mitchell 
Mitford	Algernon Bertram Freeman-Mitford, 1st Baron Redesdale 
Mitt.	William Mitten 
Miyake	Kiichi Miyake 
Mizg.	Olga F. Mizgireva 
Mizut.	Masami Mizutani 
M.Jacobs	Marius Jacobs 
M.J.Wingf.	Michael John Wingfield 
M.J.Wynne	Michael James Wynne 
M.Kato	Masahiro Kato 
M.Knowles	Matilda Cullen Knowles 
M.Kuhlm.	Moysés Kuhlmann 
M.Lange	Knud Morten Lange 
M.L.Bowerman	Mary Leolin Bowerman 
M.L.Green	Mary Letitia Green 
M.Martens	Martin Martens 
M.M.Mart.Ort.	María Montserrat Martínez Ortega 
M.Nee	Michael Nee 
M.N.Tamura	Minoru N. Tamura 
Moc.	José Mariano Mociño 
M.O.Dillon	Michael O. Dillon 
Moench	Conrad Moench 
Moestrup	Øjvind Moestrup 
Mogensen	Gert Steen Mogensen 
Moggr.	John Traherne Moggridge 
Mohl	Hugo von Mohl 
Mohlenbr.	Robert H. Mohlenbrock 
Möhring	Paul Heinrich Gerhard Möhring 
Molau	Ulf Molau 
Moldenh.	Johann Jacob Paul Moldenhawer 
Moldenke	Harold Norman Moldenke 
Molina	Juan Ignacio Molina 
Molyneux	William Mitchell Molyneux 
Mönk.	Wilhelm Mönkemeyer 
Monnard	Jean Pierre Monnard 
Mont.	Jean Pierre François Camille Montagne 
Montin	Lars Jonasson Montin 
Montgom.	Frederick Howard Montgomery 
Montrouz.	Jean Xavier Hyacinthe Montrouzier 
Moon	Alexander Moon 
Moore	David Moore 
Moq.	Christian Horace Bénédict Alfred Moquin-Tandon 
Moran	Reid Venable Moran 
Morat	Philippe Morat 
More	Alexander Goodman More 
Moretti	Giuseppe L. Moretti 
Morgan	Andrew Price Morgan 
Moric.	Stefano Moricand 
Morillo	Gilberto N. Morillo 
Moris	Giuseppe Giacinto Moris 
Morison	Robert Morison 
Moritzi	Alexander Moritzi 
Morong	Thomas Morong 
Morrison	Alexander Morrison 
Morrone	Osvaldo Morrone 
Morton	Julius Sterling Morton 
Moss	Charles Edward Moss 
Mottet	Séraphin Joseph Mottet 
Motyka	Józef Motyka 
Moug.	Jean-Baptiste Mougeot 
Mouill.	Pierre Mouillefert 
Mouterde	Paul Mouterde 
M.Peck	Morton Eaton Peck 
M.Prins	Marie Prins 
M.R.Davis	M. R. Davis 
M.R.Hend.	Murray Ross Henderson 
M.Roem.	Max Joseph Roemer 
M.R.Schomb.	Moritz Richard Schomburgk 
M.S.Baker	Milo Samuel Baker 
M.S.Balakr.	Madura S. Balakrishnan 
M.Schultze	Maximilian Johann Siegmund Schultze 
M.Serna	Marcela Serna 
M.Serres	Pierre Marcel Toussaint de Serres de Mesplès 
M.Sousa	Mario Sousa 
M.S.Young	Mary Sophie Young 
M.T.Lange	Morten Thomsen Lange 
M.T.Martin	Margaret Trevena Martin 
M.T.Strong	Mark Tuthill Strong 
Mudd	William Mudd 
Muehlenbeck	Heinrich Gustav Muehlenbeck 
Muehlenpf.	Philipp August Friedrich Mühlenpfordt 
Muhl.	Gotthilf Heinrich Ernst Muhlenberg 
Müll.Arg.	Johannes Müller Argoviensis 
Müll.Hal.	Johann Karl 
Müll.-Thurg.	Hermann Müller 
Münchh.	Otto von Münchhausen 
Mund	Johannes Ludwig Leopold Mund 
Munn	Mancel Thornton Munn 
Muñoz	Carlos Muñoz Pizarro 
Munz	Philip Alexander Munz 
Murb.	Svante Samuel Murbeck 
Murch.	Roderick Impey Murchison 
Murdock	Andrew G. Murdock 
Murr	Josef Murr 
Murray	Johan Andreas Murray 
Muschl.	Reinhold Conrad Muschler 
Mutis	José Celestino Bruno Mutis 
M.Vahl	Martin Vahl II
M.Walcott	Mary Morris Vaux Walcott 
M.Wallis	M. Wallis 
M.Williams	Margot Williams 
M.W.Chase	Mark Wayne Chase 
N.A.Br.	Nellie Adalesa Brown 
Naczi	Robert Francis Cox Naczi 
Nadeaud	Jean Nadeaud 
Nadson	Georgii Adamovich Nadson 
Nägeli	Karl Wilhelm von Nägeli 
Nakai	Takenoshin Nakai 
Nash	George Valentine Nash 
Nasution	Rusdy E. Nasution 
Naudin	Charles Victor Naudin 
Navashin	Sergei Gavrilovich Navashin 
Náves	Andrés Náves 
N.A.Wakef.	Norman Arthur Wakefield 
N.Balach.	Natesan Balachandran 
N.Busch	Nicolaĭ Adolfowitsch Busch 
N.B.Ward	Nathaniel Bagshaw Ward 
N.C.Hend.	Norlan C. Henderson 
N.E.Br.	Nicholas Edward Brown 
Neck.	Noel Martin Joseph de Necker 
Née	Luis Née 
Nees	Christian Gottfried Daniel Nees von Esenbeck 
Neger	Franz Wilhelm Neger 
N.E.Gray	Netta Elizabeth Gray 
N.E.Hansen	Niels Ebbesen Hansen 
Nehrl.	Henry Nehrling 
Neill	Patrick Neill 
Neilr.	August Neilreich 
Nel	Gert Cornelius Nel 
Nelmes	Ernest Nelmes 
Nelson	David Nelson 
Nerz	Joachim Nerz 
Ness	Helge Ness 
Nestl.	Chrétien Géofroy Nestler 
Neubert	Wilhelm Neubert 
Neveu-Lem.	Maurice Neveu-Lemaire 
Nevski	Sergei Arsenjevic Nevski 
Newb.	John Strong Newberry 
Newman	Edward Newman 
Newton	Isaac Newton 
N.F.Hend.	Nellie Frater Henderson 
N.F.Mattos	Nilza Fischer de Mattos 
N.F.Robertson	Noel Farnie Robertson 
Ng	Francis S.P. Ng 
Ngamr.	Chatchai Ngamriabsakul 
N.G.Marchant	Neville Graeme Marchant 
N.H.F.Desp.	Narcisse Henri François Desportes 
N.H.Holmgren	Noel Herman Holmgren 
Nichols	George Elwood Nichols 
Nickrent	Daniel L. Nickrent 
Nicolai	Ernst August Nicolai 
Nicolson	Dan Henry Nicolson 
Nied.	Franz Josef Niedenzu 
Nielsen	Peter Nielsen 
Nieuwl.	Julius Aloysius Arthur Nieuwland 
Nikitin	Sergei Nikolaevic Nikitin 
Nitschke	Theodor Rudolph Joseph Nitschke 
N.Jacobsen	Niels Henning Günther Jacobsen 
N.Jardine	Nick Jardine 
N.L.Alcock	Nora Lilian Alcock 
Nob.Tanaka	Nobuyuki Tanaka 
Noegg.	Johann Jakob Nöggerath 
Noerdl.	Hermann Noerdlinger 
Noltie	Henry John Noltie 
Noot.	Hans Peter Nooteboom 
Nordal	Inger Nordal 
Nordensk.	Nils Adolph Erik 
Nördl.	Herman von Nördlinger 
Nordm.	Alexander von Nordmann 
Noronha	Francisco Noronha 
Northr.	Alice Belle 
Norton	John Bitting Smith Norton 
Nothdurft	Heinrich Wilhelm Christian Nothdurft 
N.P.Balakr.	Nambiyath Puthansurayil Balakrishnan 
N.Pfeiff.	Norma Etta Pfeiffer 
N.P.Pratov	N. P. Pratov 
N.P.Taylor	Nigel Paul Taylor 
N.Ramesh	N. Ramesh 
N.Robson	Norman Keith Bonner Robson 
N.Rosén	Nils Rosén von Rosenstein 
N.Roux	Nisius Roux 
N.S.Golubk.	Nina Golubkova 
N.S.Pavlova.	N. S. Pavlova 
N.Taylor	Norman Taylor 
N.T.Burb.	Nancy Tyson Burbidge 
N.Terracc.	Nicola Terracciano 
N.T.Sauss.	Nicolas-Théodore de Saussure 
Nutt.	Thomas Nuttall 
N.W.Simmonds	Norman Willison Simmonds 
Nyár.	Erasmus Julius Nyárády 
Nygaard	Gunnar Nygaard 
Nyholm	Elsa Cecilia Nyholm 
Nyl.	
Nyman	Carl Frederik Nyman 
Oakes	William Oakes 
O.B.Davies	Olive Blanche Davies 
O.Berg	Otto Karl Berg 
Oberm.	Anna Amelia Obermeyer 
O.Bolòs	Oriol de Bolòs 
Ochoa	Carlos M. Ochoa 
Ochse	Jacob Jonas Ochse 
Ochyra	Ryszard Ochyra 
O.Cohen	Ofer Cohen 
O.C.Schmidt	Otto Christian Schmidt 
O.Danesch	Othmar Danesch 
O.Deg.	Otto Degener 
O'Donell	Carlos Alberto O'Donell 
Oeder	Georg Christian Oeder 
Oerst.	Anders Sandøe Ørsted 
O.E.Schulz	Otto Eugen Schulz 
O.F.Cook	Orator F. Cook 
O.F.Müll.	Otto Friedrich Müller 
O.Hoffm.	Karl August Otto Hoffmann 
O.Huber	Otto Huber 
Ohwi	Jisaburo Ohwi 
O.J.Rich.	Olivier Jules Richard 
Okamura	Kintaro Okamura 
Oken	Lorenz Oken 
O.K.Mill.	Orson Knapp Miller, Jr. 
Oldenl.	Henrik Bernard Oldenland 
Oldham	Thomas Oldham 
Oliv.	Daniel Oliver 
Olney	Stephen Thayer Olney 
Omino	Elizabeth Omino 
Onions	Agnes H. S. Onions 
Ooststr.	Simon Jan van Ooststroom 
Opiz	Philipp Maximilian Opiz 
Oppenh.	Heinz Reinhard Oppenheimer 
Orange	Alan Orange 
Orb.	Charles Henry Dessalines d'Orbigny 
Orcutt	Charles Russell Orcutt 
Ortega	Casimiro Gómez Ortega 
Ortgies	Karl Eduard Ortgies 
Osbeck	Pehr Osbeck 
Osborn	Arthur Osborn 
O.Schneid.	Oskar Schneider 
Oshio	Masayoshi Oshio 
Oshite	Kei Oshite 
Osipian	Lia Levonevna Osipian 
Ósk.	Ingimar Óskarsson 
Osner	George Adin Osner 
Osorio	Hector S. Osorio 
Ospina	Hernandez Mariano Ospina 
Ossa	José Antonio de la Ossa 
Osswald	Louis Osswald 
Ossyczn.	V. V. Ossycznjuk 
Ostapko	V. M. Ostapko 
Osten	Cornelius Osten 
Ostenf.	Carl Hansen Ostenfeld 
Oterdoom	Herman John Oterdoom 
Osterh.	George Everett Osterhout 
Osterm.	Franz Ostermeyer 
Osterwald	Karl Osterwald 
Osterw.	Adolph Osterwalder 
Östman	Magnus Östman 
Østrup	Ernst Vilhelm Østrup 
Osvač.	Vera Osvačilová 
Otth	Carl Adolf Otth 
Otto	Christoph Friedrich Otto 
Ottol.	Kornelius Johannes Willem Ottolander 
Oudejans	Robertus Cornelis Hilarius Maria Oudejans 
Oudney	Walter Oudney 
Overeem	Casper van Overeem 
O.Yano	Olga Yano 
O.Zacharias	Emil Otto Zacharias 
Pabst	Guido Frederico João Pabst 
P.A.Cox	P. A. Cox 
P.A.Dang.	Pierre Augustin Dangeard 
Pagan	Francisco Mariano Pagan 
Paine	John Alsop Paine 
Painter	William Hunt Painter 
Palassou	Pierre Bernard Palassou 
Palez.	Philippe de Palézieux 
Palib.	Ivan Vladimirovich Palibin 
Pall.	Peter Simon von Pallas 
Palla	Eduard Palla 
Pallith.	Joseph Pallithanam 
P.Allorge	Pierre Allorge 
Palm	Björn Torvald Palm 
Palmberg	Johannes Olai Palmberg 
Palmer	Edward Palmer 
Palmgr.	Alvar Palmgren 
Pamp.	Renato Pampanini 
Pancher	Jean Armand Isidore Pancher 
Pančić	Josif Pančić 
Pandé	S. K. Pandé 
Pandeir.	Mariana Sofia Pandeirada 
Pander	Heinz Christian Pander 
Pando	Francisco Pando 
Panero	José L. Panero 
Panfet	Cristina Mercedes Panfet Valdés 
Pangalo	Konstantin Ivanovič Pangalo 
Panigrahi	Gopinath Panigrahi 
Panizzi	Francesco Panizzi 
Panjutin	Platon Sergeevich Panjutin 
Pankow	Helmut Pankow 
Pannell	Caroline M. Pannell 
Panov	P. P. Panov 
Pansche	Adolf Pansche 
Pant.	Jószef Pantocsek 
Pantaz.	Andriana Pantazidou 
Panter	Jacqueline Anne Panter 
Panthaki	Dhun Phiroze Panthaki 
Pantl.	Robert Pantling 
Panțu	Zacharia C. Panțu 
Panz.	Georg Wolfgang Franz Panzer 
Paol.	Giulio Paoletti 
Papan.	Konstantinos Papanicolaou 
Pappe	Karl Wilhelm Ludwig Pappe 
Parijs	J. P. Parijs
Paris	Jean Édouard Gabriel Narcisse Paris 
Parish	Samuel Bonsall Parish 
Parl.	Filippo Parlatore 
Parm.	Antoine Auguste Parmentier 
Parodi	Lorenzo Raimundo Parodi 
Parry	Charles Christopher Parry 
Pascher	Adolf Pascher 
Pass.	Giovanni Passerini 
Passarge	Otto Karl Siegfried Passarge 
Passy	Antoine François Passy 
Pasteur	Louis Pasteur 
Pat.	Narcisse Théophile Patouillard 
Patel	M. K. Patel 
Paterson	William Paterson 
Patrin	Eugène Louis Melchior Patrin 
Pau	Carlos Pau 
Paul G.Wilson	Paul Graham Wilson 
Paulsen	Ove Paulsen 
Paunero	Elena Paunero Ruiz 
Pav.	José Antonio Pavón Jiménez 
Pavlov	Nikolai Vasilievich Pavlov 
Pavol.	Angiolo Ferdinando Pavolini 
Pawł.	Bogumił Pawłowski 
Pax	Ferdinand Albin Pax 
Paxton	Joseph Paxton 
Payens	Joannes Petrus Dominicus Wilhelmus Payens 
P.B.Adams	P. B. Adams 
P.Beauv.	Ambroise Marie François Joseph Palisot de Beauvois 
P.Browne	Patrick Browne 
P.C.Boyce	Peter Charles Boyce 
P.Chai	Paul P. K. Chai 
P.C.Kanjilal	Praphulla Chandra Kanjilal 
P.C.Pant	P. C. Pant 
P.Daniel	Pitchai Daniel 
P.de la Varde	Robert André Léopold Potier de la Varde 
P.Delforge	Pierre Delforge 
P.D.Orton	Peter Darbishire Orton 
Pearl	Raymond Pearl 
Pearse	Arthur Sperry Pearse 
Pearson	William Henry Pearson 
Pease	Arthur Stanley Pease 
Peattie	Donald C. Peattie 
P.E.Barnes	P.E. Barnes 
P.E.Berry	Paul Edward Berry 
Peck	Charles Horton Peck 
Peckham	Ethel Anson Peckham 
Peckoit	Gustav Peckoit 
Peckolt	Theodor Peckolt 
Pěčková	Milena Pěčková 
Peckover	Ralph Peckover 
Pedersen	Troels Myndel Pedersen 
Pedley	Leslie Pedley 
Peebles	Robert Hibbs Peebles 
Pellegr.	François Pellegrin 
Pelloe	Emily Harriet Pelloe 
Pelser	Pieter B. Pelser 
Penh.	David Pearce Penhallow 
Penn.	Leigh Humboldt Pennington 
Pennant	Thomas Pennant 
Pennell	Francis Whittier Pennell 
Penz.	Albert Julius Otto Penzig 
Pépin	Pierre Denis Pépin 
Perch-Nielsen	Katharina Perch-Nielsen
Percival	John Percival 
Perkins	Janet Russell Perkins 
Perktold	Josef Anton Perktold 
Perleb	Karl Julius Perleb 
Perr.	George Samuel Perrottet 
Perrier	Alfred Perrier 
Perrine	Henry Perrine 
Pers.	Christiaan Hendrik Persoon 
Perss.	Nathan Petter Herman Persson 
Perty	Josef 
Petagna	Vincenzo Petagna 
Peter	
Peter G.Wilson	Peter Gordon Wilson 
Peters	Wilhelm Carl Hartwig Peters 
Petr.	Franz Petrak 
Petrie	Donald Petrie 
Petrov	Vsevolod Alexeevič Petrov 
Petz.	Carl Edward Adolph Petzold 
Peyr.	Johann Joseph Peyritsch 
Pfahl	Jay Charles Pfahl 
Pfeff.	Wilhelm Pfeffer 
Pfeiff.	Louis 
Pfeil	Friedrich Wilhelm Leopold Pfeil 
Pfennig	Horst Pfennig 
Pfiester	Lois Ann Pfiester 
Pfitzer	Ernst Hugo Heinrich Pfitzer 
Pfosser	Martin Pfosser 
P.Fourn.	Paul Victor Fournier 
P.F.Stevens	Peter F. Stevens 
P.Geissler	Patricia Geissler 
P.H.Allen	Paul H. Allen 
P.H.Davis	Peter Hadland Davis 
P.Hein	Peter Hein 
P.H.Hô	Pham-Hoàng Hô 
Phil.	Rodolfo Amando Philippi 
Philcox	David Philcox 
Philippe	Xavier Philippe 
Philipson	William Raymond Philipson 
Phillippe	Loy R. Phillippe 
Phillipps	Anthea Phillipps 
Phipps	Constantine John Phipps 
Phoebus	Philipp Phoebus 
P.H.Raven	Peter Hamilton Raven 
Pichon	Marcel Pichon 
Pickering	Charles Pickering 
Pickersgill	Barbara Pickersgill 
Pickett	Fermen Layton Pickett 
Pickford	Grace Evelyn Pickford 
Pic.Serm.	Rodolfo Emilio Giuseppe Pichi Sermolli 
Pierrat	Dominique Pierrat 
Pierre	Jean Baptiste Louis Pierre 
P.I.Forst.	Paul Irwin Forster 
Pignatti	Sandro Pignatti 
Piippo	Sinikka Piippo 
Pilát	Albert Pilát 
Pilg.	Robert Knud Friedrich Pilger 
Pillans	Neville Stuart Pillans 
Pilous	Zdeněk Pilous 
P.I.Mao	Pin I Mao 
Pinchot	Gifford Pinchot 
Piper	Charles Vancouver Piper 
Pipoly	John J. Pipoly III 
Piré	Louis Alexandre Henri Joseph Piré 
Pires	João Murça Pires 
Pires-O'Brien	Maria Joaquina Pires-O'Brien 
Pirone	Pascal Pompey Pirone 
Pirotta	Pietro Romualdo Pirotta 
Piso	Willem 
Pit.	Charles-Joseph Marie Pitard 
Pitcher	Zina Pitcher 
Pittier	Henri François Pittier 
P.J.Adey	Patricia J. Adey 
P.J.Bergius	Peter Jonas Bergius 
P.J.Braun	Pierre Josef Braun 
P.J.Cribb	Phillip James Cribb 
P.J.L.Dang.	Pierre Jean Louis Dangeard 
P.J.Müll.	Philipp Jakob Müller 
P.Karst.	Petter Adolf Karsten 
P.K.Endress	Peter Karl Endress 
P.K.Holmgren	Patricia Kern Holmgren 
P.K.Hsiao	Pei Ken Hsiao 
P.Kumm.	Paul Kummer 
Planch.	Jules Émile Planchon 
Plée	Auguste Plée 
Plowr.	Charles Bagge Plowright 
Pluk.	Leonard Plukenet 
Plum.	Charles Plumier 
Plummer	Sara Allen Plummer 
Plumst.	Edna Pauline Plumstead 
P.MacGill.	Paul Howard MacGillivray 
P.Martin	Paul Martin 
Pobed.	Evgeniia Georgievna Pobedimova 
Pocock	Mary Agard Pocock 
Pócs	Tamás Pócs 
Podp.	Josef Podpera 
Poederlé	Eugene Josef Charles Gilain Hubert d'Olmen Poederlé 
Poelt	Josef Poelt 
Poepp.	Eduard Friedrich Poeppig 
Poggenb.	Justus Ferdinand Poggenburg I 
Pohl	Johann Baptist Emanuel Pohl 
Pohle	Christian Nikolai Richard Pohle 
Poir.	Jean Louis Marie Poiret 
Poiss.	Henri Louis Poisson 
Poit.	Pierre Antoine Poiteau 
Poivre	Pierre Poivre 
Pojark.	Antonina Ivanovna Pojarkova 
Pokle	Dileep Sadashivrao Pokle 
Pokorny	Alois 
Polatschek	Adolf Polatschek 
Pole-Evans	Illtyd 
Poljakov	Petr Petrovich Poljakov 
Pollard	Charles Louis Pollard 
Pollexf.	John Hutton Pollexfen 
Pollich	Johan Adam Pollich 
Pollock	James Barkley Pollock 
Pomel	Auguste Pomel 
Poole	Alick Lindsay Poole 
Popl.	Henrietta Ippolitovna Poplavskaja 
Popov	Mikhail Grigoríevič Popov 
Poppelw.	Dugald Louis Poppelwell 
Porter	Thomas Conrad Porter 
Porto	Paulo Campos Porto 
Poselg.	Heinrich Poselger 
Posp.	Eduard Pospichal 
Post	George Edward Post 
Pourr.	Pierre André Pourret 
Pouzolz	Pierre Marie Casmir de Pouzolz 
P.Petit	Paul Charles Mirbel Petit 
Prada	María del Carmen Isabel Prada 
Pradal	Émile Pradal 
Pradeep	Ayilliath K. Pradeep 
Pradhan	Udai Chandra Pradhan 
Praeger	Robert Lloyd Praeger 
Praet.	Ignaz Praetorius 
Prag.	Ernst Prager 
Prahl	Peter Prahl 
Prain	David Prain 
Prak.Rao	Chellapilla Surya Prakasa Rao 
Pramanik	B. B. Pramanik 
P.Ramesh	Polluri Ramesh 
Prance	Ghillean Tolmie Prance 
Prantl	Karl Anton Eugen Prantl 
Prassler	Maria Prassler 
Prát	Silvestr Prát 
Prather	L. Alan Prather 
Pratt	Anne Pratt 
Pray	Thomas Richard Pray 
Preble	Edward Alexander Preble 
Pringle	Cyrus Pringle 
Pringsh.	Nathanael Pringsheim 
Priszter	Szaniszló Priszter 
Pritz.	George August Pritzel 
P.R.O.Bally	Peter René Oscar Bally 
Prodan	Iuliu Prodan 
Profice	Sheila Regina Profice 
Prokh.	Jaroslav Ivanovic Prokhanov 
Prosk.	Johannes Max Proskauer 
Prowazek	Stanislaus von Prowazek 
P.Royen	Pieter van Royen 
Pryer	Kathleen M. Pryer 
P.Sarasin	Paul Benedict Sarasin 
P.S.Ashton	Peter Shaw Ashton 
P.Schneid.	Peter Schneider 
P.Selby	Prideaux John Selby 
P.S.Green	Peter Shaw Green 
P.Silva	António Rodrigo Pinto da Silva 
P.S.Liu	Pei Song Liu 
P.S.Soltis	Pamela S. Soltis 
P.Stark	Peter Stark 
P.S.Wyse Jacks.	Peter Wyse Jackson 
P.Syd.	Paul Sydow 
P.Taylor	Peter Geoffrey Taylor 
P.Temple	Paul Temple 
P.T.Li	Ping Tao Li 
Puget	François Puget 
Pugsley	Herbert William Pugsley 
Pulle	August Adriaan Pulle 
Pult.	Richard Pulteney 
Purchas	William Henry Purchas 
Purdie	William Purdie 
Purdom	William Purdom 
Purk.	Emanuel von Purkyně 
Purpus	Carl Albert Purpus 
Pursh	Frederick Traugott Pursh 
Purton	Thomas Purton 
Putnam	George Palmer Putnam 
Putz.	Jules Putzeys 
P.Watson	Peter William Watson 
P.W.Ball	Peter William Ball 
P.Wilson	P.Wilson 
P.Y.Chen	Pang Yu Chen 
Pynaert	Edouard-Christophe Pynaert 
Q.D.Clarkson	Quentin Deane Clarkson 
Quehl	Leopold Quehl 
Quél.	Lucien Quélet 
Quinn	Christopher John Quinn 
Quisumb.	Eduardo Quisumbíng y Argüelles 
Quoy	Jean René Constant Quoy 
Q.Wang	Qi Wang 
Q.W.Zeng	Qing Wen Zeng 
Rach	Louis Theodor Rach 
R.A.Clement	Rose A. Clement 
Radcl.-Sm.	Alan Radcliffe-Smith 
Raddi	Giuseppe Raddi 
Raderm.	Jacob Cornelis Matthieu Radermacher 
Radford	Albert Ernest Radford 
Radius	Justus Wilhelm Martin Radius 
Radlk.	Ludwig Adolph Timotheus Radlkofer 
R.A.Dyer	Robert Allen Dyer 
Raeusch.	Ernst Adolf Raeuschel 
Raf.	Constantine Samuel Rafinesque 
Raffles	Thomas Stamford Bingley Raffles 
Rafn	Carl Gottlob Rafn 
R.A.Foster	Robert A. Foster 
R.A.Harper	Robert Almer Harper 
Rahn	Knud Rahn 
R.A.Howard	Richard Alden Howard 
Raim.	Rudolph Raimann 
Ralfs	John Ralfs 
Ralph Hoffm.	Ralph Hoffmann 
Ram.Goyena	Miguel Ramírez Goyena 
Ramond	Louis Ramond de Carbonnières 
Rand	Isaac Rand 
Randolph	Lowell Fitz Randolph 
Rands	Robert Delafield Rands 
Raoul	Etienne Fiacre Louis Raoul 
Rapaics	Raymund Rapaics von Rumwerth 
Rapin	Daniel Rapin 
Rasm.	Rasmus Rasmussen 
Raspail	François Vincent Raspail 
Rataj	Karel Rataj 
Rattan	Volney Rattan 
Ratzeb.	Julius Theodor Christian Ratzeburg 
Rauh	Werner Rauh 
Raunk.	Christen C. Raunkiær 
Raup	Hugh Miller Raup 
Rauschert	Stephan Rauschert 
Rauwolff	Leonhard 
Raven	John Earle Raven 
Ravenna	Pierfelice Ravenna 
R.A.W.Herrm.	Rudolf Albert Wolfgang Herrmann 
R.A.White	Richard Alan White 
Rawitscher	Felix Rawitscher 
Rawson	Rawson W. Rawson 
Ray	John Ray 
Raym.-Hamet	Raymond Hamet 
Raymond	Louis-Florent-Marcel Raymond 
Raynaud	Christian Raynaud 
Rayner	John Frederick Rayner 
Rayss	Tscharna Rayss 
Razaf.	Alfred Razafindratsira 
Razafim.	Sylvain G. Razafimandimbison 
R.B.Clark	Robert Brown Clark 
R.Bernal	Rodrigo Bernal 
R.Br.	Robert Brown 
R.Br.bis	Robert Brown 
R.Br.ter	Robert Brown 
R.B.Singer	Rodrigo Bustos Singer 
R.B.Wallis	Robert B. Wallis 
R.C.Clark	Ross C. Clark 
Rchb.	Heinrich Gottlieb Ludwig Reichenbach 
Rchb.f.	Heinrich Gustav Reichenbach 
R.C.Foster	Robert Crichton Foster 
R.C.Jacks.	Raymond Carl Jackson 
R.Clark	Ruth Clark 
R.C.Moran	Robbin C. Moran 
R.C.Palmer	Richard Charles Palmer 
R.C.Schneid.	Richard Conrad Schneider 
R.C.Sinclair	Robert C. Sinclair 
R.Cunn.	Richard Cunningham 
R.Dahlgren	Rolf Martin Theodor Dahlgren 
R.D.Good	Ronald D'Oyley Good 
R.Doll	Reinhard Doll 
R.D.Spencer	Roger David Spencer 
Reader	Felix Reader 
Reboul	Eugène de Reboul 
R.E.Brooks	Ralph Edward Brooks 
Rech.	Karl Rechinger 
Rech.f.	Karl Heinz Rechinger 
R.E.Clausen	Roy Elwood Clausen 
R.E.Cleland	Ralph Erskine Cleland 
Record	Samuel James Record 
R.E.Daniels	Roger Edward Daniels 
R.E.D.Baker	Richard Eric Defoe Baker 
Redouté	Pierre-Joseph Redouté 
Rees	Abraham Rees 
R.E.Fr.	Robert Elias Fries 
Regel	Eduard August von Regel 
Rehder	Alfred Rehder 
Rehmann	Anton Rehmann 
Reichard	Johann Jacob Reichard 
Reiche	Karl Friedrich Reiche 
Reichert	Israel G. Reichert 
Reichst.	Tadeus Reichstein 
Reinke	Johannes Reinke 
Reinsch	Paul Friedrich Reinsch 
Reinw.	Caspar Georg Carl Reinwardt 
Reiss	Frederick Reiss 
Reissek	Siegfried Reisseck 
R.E.Kunze	Richard Ernest Kunze 
R.E.Lee	Robert Edwin Lee 
R.Emers.	Ralph Emerson 
Renault	Bernard Renault 
Rendle	Alfred Barton Rendle 
Renvoize	Stephen Andrew Renvoize 
Req.	Esprit Requien 
R.E.Schult.	Richard Evans Schultes 
R.Escobar	Rodrigo Escobar 
Resv.-Holms.	Hanna Resvoll-Holmsen 
Resvoll	Thekla Resvoll 
Retz.	Anders Johan Retzius 
Reut.	George François Reuter 
Reveal	James Lauritz Reveal 
R.Fern.	Rosette Batarda Fernandes 
R.F.Martin	Robert Franklin Martin 
R.Harkn.	Robert Harkness 
R.Hartig	Heinrich Julius Adolph Robert Hartig 
Rheede	Hendrik Adriaan van Rheede tot Drakenstein 
R.H.Miao	Ru Huai Miao 
Rhode	Johann Gottlieb Rhode 
R.Hoffm.	Reinhold Hoffmann 
R.Hogg	Robert Hogg 
R.H.Petersen	Ronald H. Petersen 
R.H.Roberts	Richard Henry Roberts 
R.H.Schomb.	Robert Hermann Schomburgk 
R.H.Wallace	R. H. Wallace 
Riccob.	Vincenzo Riccobono 
Rich.	Louis Claude Marie Richard 
Richardson	John Richardson 
Richens	Richard Hook Richens 
Richerson	Peter James Richerson 
Ricken	Adalbert Ricken 
Ricker	Percy Leroy Ricker 
Ricketson	Jon M. Ricketson 
Riddell	John Leonard Riddell 
Ridl.	Henry Nicholas Ridley 
Ridsdale	Colin Ernest Ridsdale 
Rieder	Conly Leroy Rieder 
Riedel	Ludwig Riedel 
Riedl	Harald Udo von Riedl 
Říha	Jan Říha 
Rink	Hinrich 
Riocreux	Alfred Riocreux 
Risso	Antoine Risso 
Riv.	Augustus Quirinus Rivinus 
Rivière	Marie Auguste Rivière 
Rix	Edward Martyn Rix 
Rizzini	Carlos Toledo Rizzini 
R.J.Bayer	Randall James Bayer 
R.J.F.Hend.	Rodney John Francis Henderson 
R.J.Moore	Raymond John Moore 
R.J.Roberts	Ronald John Roberts 
R.J.Scheff.	R. J. Scheffer 
R.Keller	Robert Keller 
R.K.Godfrey	Robert Kenneth Godfrey 
R.Kiesling	Roberto Kiesling 
R.Klebs	Richard Klebs 
R.Knuth	Reinhard Gustav Paul Knuth 
R.K.S.Lee	Robert Kui Sung Lee 
R.Lesson	René Primevère Lesson 
R.M.Harper	Roland McMillan Harper 
R.M.Johnst.	Robert Mackenzie Johnston 
R.M.King	Robert Merrill King 
R.Morales	Ramón Morales Valverde 
R.Morgan	Robert Morgan 
R.M.Patrick	Ruth Patrick 
R.M.Schust.	Rudolf M. Schuster 
R.M.Tryon	Rolla Milton Tryon, Jr. 
R.N.R.Br.	Robert Neal Rudmose-Brown 
Rob.	William Robinson 
Robatsch	Karl Robatsch 
Robbertse	Petrus Johannes Robbertse 
Robbr.	Elmar Robbrecht 
Roberg	Lars Roberg 
Robert	Gaspard Nicolas Robert 
Robertson	David Robertson 
Roberty	Guy Edouard Roberty 
Robyns	Frans Hubert Edouard Arthur Walter Robyns 
Rochebr.	Alphonse Trémeau de Rochebrune 
Rock	Joseph Rock 
R.O.Cunn.	Robert Oliver Cunningham 
Rodin	Hippolyte Rodin 
Rodion.	Georgi Ivanovich Rodionenko 
Rodr.	José Demetrio Rodrígues 
Rodway	Leonard Rodway 
Roem.	Johann Jacob Roemer 
Roezl	Benedikt Roezl 
Roffavier	Georges Roffavier 
Rogerson	Clark Thomas Rogerson 
Rogow.	Athanasi Semenovich Rogowicz 
Rohde	Michael Rohde 
Röhl.	Johann Christoph Röhling 
Rohr	Julius Philip Benjamin von Röhr 
Rohrb.	Paul Rohrbach 
Roiv.	Heikki Roivainen 
Rolfe	Robert Allen Rolfe 
Rolland	Léon Louis Rolland 
Rollins	Reed Clark Rollins 
Romagn.	Henri Romagnesi 
Romans	Bernard Romans 
Rondelet	Guillaume Rondelet 
Rooke	Hayman Rooke 
Rose	Joseph Nelson Rose 
Rosend.	Carl Otto Rosendahl 
Roseng.	Bernardo Rosengurtt 
Rosenstein	Nils Rosén von Rosenstein 
Rosenv.	Janus Lauritz Andreas Kolderup Rosenvinge 
Ross	John Ross 
Rossi	Pietro Rossi 
Rossm.	Emil Adolf 
Rostaf.	Józef Thomasz Rostafiński 
Rostk.	Friedrich Wilhelm Gottlieb Theophil Rostkovius 
Rostr.	Frederik Georg Emil Rostrup 
Rota	Lorenzo Rota 
Roth	Albrecht Wilhelm Roth 
Rothm.	Werner Hugo Paul Rothmaler 
Rothr.	Joseph Trimble Rothrock 
Rothsch.	Jules Rothschild 
Rot Schreck.	Friedrich Rot von Schreckenstein 
Rottb.	Christen Friis Rottbøll 
Roubaud	Émile Roubaud 
Roupell	Arabella Elizabeth Roupell 
Rourke	John Patrick Rourke 
Rousseau	Jean-Jacques Rousseau 
Roussel	Henri François Anne de Roussel 
Roux	Jacques Roux 
Rouy	Georges C.Chr. Rouy 
Rowntree	Lester Gertrude Ellen Rowntree 
Roxb.	William Roxburgh 
Royen	Adriaan van Royen 
Royle	John Forbes Royle 
Roy L.Taylor	Roy L. Taylor 
Rozier	François Rozier 
R.Parker	Richard Neville Parker 
R.Pott	Reino Pott 
R.P.White	Richard Peregrine White 
R.Rabev.	Raymond Rabevohitra 
R.R.Bloxam	Richard Rowland Bloxam 
R.R.Haynes	Robert Ralph Haynes 
R.Ross	Robert Ross 
R.R.Scott	Robert Robinson Scott 
R.R.Stewart	Ralph Randles Stewart 
R.S.Almeida	Rafael S. Almeida 
R.Schultz	Richard Schultz 
R.S.Cowan	Richard Sumner Cowan 
R.S.Irving	Robert Stewart Irving 
R.S.Rogers	Richard Sanders Rogers 
R.S.Wallace	Robert S. Wallace 
R.S.Williams	Robert Statham Williams 
R.T.Baker	Richard Thomas Baker 
R.T.Clausen	Robert Theodore Clausen 
Rudall	Paula J. Rudall 
Rudge	Edward Rudge 
Rudolphi	Karl Rudolphi 
Ruhland	Wilhelm Otto Eugen Ruhland 
Ruiz	Hipólito Ruiz López 
Rumph.	Georg Eberhard Rumphius 
Rümpler	Karl Theodor Rümpler 
Rundel	Philip Wilson Rundel 
Rupr.	Franz Josef Ruprecht 
Rusby	Henry Hurd Rusby 
Russow	Edmund August Friedrich Russow 
Rustan	Ovind H. Rustan 
Rutenb.	Diedrich Christian Rutenberg 
Rutherf.	Daniel Rutherford 
Ruysch	Frederik Ruysch 
R.Vásquez	Roberto Vásquez 
R.Vig.	René Viguier 
R.Wagner	Rudolf Wagner 
R.Wallis	Rannveig Wallis 
R.W.Br.	Roland Wilbur Brown 
R.W.Darwin	Robert Waring Darwin of Elston 
R.W.Pohl	Richard Walter Pohl 
R.W.Wallace	Robert Whistler Wallace 
Rydb.	Per Axel Rydberg 
Ryppowa	Halina w Kowalskich Ryppowa 
Sabine	Joseph Sabine 
Sabourin	Lucien Sabourin 
Sacc.	Pier Andrea Saccardo 
Sachet	Marie-Hélène Sachet 
Sachs	Julius von Sachs 
Sacleux	Charles Sacleux 
Sadeb.	Richard Emil Benjamin Sadebeck 
Saff.	William Edwin Safford 
Sagást.	Abundio Sagástegui Alva 
Sahlb.	Carl Reinhold Sahlberg 
Sahni	Birbal Sahni 
Sa.Kurata	Satoru Kurata 
Salisb.	Richard Anthony Salisbury 
Salm-Dyck	Joseph zu Salm-Reifferscheidt-Dyck 
Salmon	John Drew Salmon 
Samp.	Gonçalo António da Silva Ferreira Sampaio 
Sander	Henry Frederick Conrad Sander 
S.Andrews	Susyn M. Andrews 
Sandwith	Noel Yvri Sandwith 
S.A.Nikitin	Sergei Alekseevich Nikitin 
Sanjappa	Munivenkatappa Sanjappa 
Santapau	Hermenegild Santapau 
Santin	Dionete Aparecida Santin 
Saporta	Louis Charles Joseph Gaston de Saporta 
Saralegui	Hildelisa Saralegui Boza 
Sarasin	Karl Friedrich Sarasin 
Sarato	César Sarato 
Sarauw	Georg Frederik Ludvig Sarauw 
Sarg.	Charles Sprague Sargent 
S.Arn.	Samuel Arnott 
Sarnth.	Ludwig von Sarnthein 
Sart.	Giovanni Battista Sartorelli 
Sartori	Joseph Sartori 
Sartwell	Henry Parker Sartwell 
Sasaki	Shun-ichi Sasaki 
Sasidh.	N. Sasidharan 
Satow	Ernest Mason Satow 
Sauss.	Horace-Bénédict de Saussure 
Sauv.	Camille François Sauvageau 
Sauvages	François Boissier de Sauvages de Lacroix 
Sauvalle	Francisco Adolfo Sauvalle 
Sav.	Paul Amedée Ludovic Savatier 
Savi	Gaetano Savi 
Savigny	Marie Jules César Lélorgne de Savigny 
Săvul.	Traian Săvulescu 
Saw	Leng Guan Saw 
Sax	Karl Sax 
Say	Thomas Say 
Sayre	Geneva Sayre 
S.B.Andrews	S. Brian Andrews 
S.B.Jundz.	Stanisław Bonifacy Jundziłł 
S.Blackmore	Stephen Blackmore 
Scannell	Maura J.P. Scannell 
S.Carter	Susan Carter Holmes 
S.C.Chen	Sing Chi Chen 
S.C.Darwin	Sarah Darwin 
Schäf.-Verw.	Alfons Schäfer-Verwimp 
Scharf	Uwe Scharf 
Schauer	Johannes Conrad Schauer 
Sch.Bip.	Carl Heinrich 'Bipontinus' Schultz 
Schchian	Anna Semenovna Schchian 
Scheb.	M. A. Schebalina 
Scheele	George Heinrich Adolf Scheele 
Scheer	Friedrich Scheer 
Scheff.	Rudolph Herman Christiaan Carel Scheffer 
Scheffers	W. A. Scheffers 
Scheffler	Wolfram Scheffler 
Scheibe	Arnold Scheibe 
Scheidw.	Michael Joseph François Scheidweiler 
Scheit	Max Scheit 
Schelk.	Alexandr Bebutovicz Schelkownikow 
Schelle	Ernst Schelle 
Schellenb.	Hans Conrad Schellenberg 
Schelpe	Edmund André Charles Lois Eloi Schelpe 
Schelver	Friedrich Joseph Schelver 
Schemmann	Wilhelm Schemmann
Schemske	Douglas W. Schemske 
Schenck	Johann Heinrich Rudolf Schenck 
Schenk	Joseph August Schenk 
Scherb.	Johannes Scherbius 
Scherer	Johann Andreas Scherer 
Scherfel	Aurel Wilhelm Scherfel 
Scherff.	Aladár Scherffel 
Schery	Robert Walter Schery 
Scheuchzer f.	Johannes Scheuchzer 
Scheuerm.	Richard Scheuermann 
Scheutz	Nils Johan Wilhelm Scheutz 
Schewe	O. Schewe 
Schew.	Wladimir Schewiakoff 
Scheygr.	Arie Scheygrond 
Schiede	Christian Julius Wilhelm Schiede 
Schiffn.	Victor Félix Schiffner 
Schimp.	Wilhelm Philippe Schimper 
Schindl.	Anton Karl Schindler 
Schinz	Hans Schinz 
Schischk.	Boris Konstantinovich Schischkin 
Schleid.	Matthias Jakob Schleiden 
Schltdl.	Diederich Franz Leonhard von Schlechtendal 
Schltr.	Rudolf Schlechter 
Schmalh.	Johannes Theodor Schmalhausen 
Schmeil	Franz Otto Schmeil 
Schnabl	Johann Nepomuk Schnabl 
Schnack	Benno Julio Christian Schnack 
Schnarf	Karl Schnarf 
Schneck	Jacob Schneck 
Schnee	Ludwig Schnee 
Schneev.	George Voorhelm Schneevoogt 
Schnegg	Hans Schnegg 
Schneid.-Bind.	E. Schneider-Binder 
Schneid.-Or.	Otto Schneider-Orelli 
Schnekker	Johannes Daniel Schnekker 
Schnell	Raymond Albert Alfred Schnell 
Schneller	Johann Jakob Schneller 
Schnepf	Eberhard Schnepf 
Schnetter	Reinhard Schnetter 
Schnetzl.	Johann Balthasar Schnetzler 
Schnittsp.	Georg Friedrich Schnittspahn 
Schnizl.	Adalbert Carl Friedrich Hellwig Conrad Schnizlein 
Schodde	Richard Schodde 
Schoenef.	Wladimir de Schoenefeld 
Schoepff	Johann David Schoepff 
Schönb.-Tem.	Eva Schönbeck-Temesy 
Schönl.	Johann Lucas Schönlein 
Schönland	Selmar Schönland 
Schornh.	Ruth Olive Schornhurst Breen 
Schott	Heinrich Wilhelm Schott 
Schottky	Ernst Max Schottky 
Schousb.	Peder Kofod Anker Schousboe 
Schrad.	Heinrich Adolph Schrader 
Schrank	Franz Paula von Schrank 
Schreb.	Johann Christian Daniel von Schreber 
Schrenk	Alexander Gustav von Schrenk 
Schröt.	Carl Joseph Schröter 
Schub.	Gotthilf Heinrich von Schubert 
Schübl.	Gustav Schübler 
Schuit.	André Schuiteman 
Schult.	Josef August Schultes 
Schult.f.	Julius Hermann Schultes 
Schultz	Carl Friedrich Schultz 
Schultz Sch.	Carl Heinrich 'Schultzenstein' Schultz 
Schum.	Julius 
Schumach.	Heinrich Christian Friedrich Schumacher 
Schur	Philipp Johann Ferdinand Schur 
Schwägr.	Christian Friedrich Schwägrichen 
Schwartz	Ernest Justus Schwartz 
Schweick.	Herold Georg Wilhelm Johannes Schweickerdt 
Schweigg.	August Friedrich Schweigger 
Schwein.	Lewis David von Schweinitz 
Schweinf.	Georg August Schweinfurth 
Schwer.	Fritz Kurt Alexander von Schwerin 
S.C.Lee	Shun Ching Lee 
Scop.	Giovanni Antonio Scopoli 
Scort.	Benedetto Scortechini 
Scott-Elliot	George Francis Scott-Elliot 
Scribn.	Frank Lamson Scribner 
S.C.Srivast.	Suresh Chandra Srivastava 
S.Curtis	Samuel Curtis 
S.D.Jones	Stanley D. Jones 
S.Dressler	Stefan Dressler 
Sealy	Joseph Robert Sealy 
Seaver	Fred Jay Seaver 
Secr.	Louis Secretan 
Seem.	Berthold Carl Seemann 
Seenus	Josef von Seenus 
Seetzen	Ulrich Jaspar Seetzen 
Ség.	Jean François Séguier 
Seibert	Russell Jacob Seibert 
Seidenf.	Gunnar Seidenfaden 
Seigler	David Stanley Seigler 
Seisums	A. G. Seisums 
Selander	Nils Sten Edvard Selander 
Sellow	Friedrich Sellow 
Semple	John Cameron Semple 
Sendtn.	Otto Sendtner 
Seneb.	Jean Senebier 
Senghas	Karlheinz Senghas 
Sennen	Frère Sennen 
Sennholz	Gustav Sennholz 
Sennikov	Alexander Nikolaevitsch Sennikov 
Ser.	Nicolas Charles Seringe 
Serra	Luis Serra 
Sessé	Martín Sessé y Lacasta 
Setch.	William Albert Setchell 
Seub.	Moritz August Seubert 
Seward	Albert Charles Seward 
S.F.Blake	Sidney Fay Blake 
S.G.Gmel.	Samuel Gottlieb Gmelin
S.G.Hao	Shu-Gang Hao 
S.G.Pradhan	Sudhir Gajanan Pradhan 
Shadbolt	George Shadbolt 
Shafer	John Adolph Shafer 
Shaler	Nathaniel Southgate Shaler 
Sharsm.	Carl William Sharsmith 
S.Hatt.	Sinske Hattori 
Shaver	Jesse Milton Shaver 
Shear	Cornelius Lott Shear 
Sheppard	Harriet Campbell Sheppard 
Sherff	Earl Edward Sherff 
Shevock	James Robert Shevock 
Shibata	Keita Shibata 
Shiller	Ivan Shiller 
Shimek	Bohumil Shimek 
Shinners	Lloyd Herbert Shinners 
Shipunov	Alexey B. Shipunov 
Shiras.	Yasuyoshi 
S.H.Kang	Shin Ho Kang 
Sh.Kurata	Shigeo Kurata 
S.H.Lin	Shan Hsiung Lin 
Shockley	William Hillman Shockley 
Short	Charles Wilkins Short 
Shreve	Forrest Shreve 
Shrock	Robert Rakes Shrock 
Shull	George Harrison Shull 
Shultz	Benjamin Shultz 
Shute	Cedric H. Shute 
Shuttlew.	Robert James Shuttleworth 
Sibth.	John Sibthorp 
Sickenb.	Ernst Sickenberger 
Sieber	Franz Sieber 
Siebold	Philipp Franz von Siebold 
Siehe	Walter Siehe 
Sierra	Eugeni Sierra 
Siev.	Johann August Carl Sievers 
Silliman	Benjamin Silliman 
Silva Manso	António Luiz Patricio da Silva Manso 
Sim	Thomas Robertson Sim 
Sim.-Bianch.	Rosangela Simão-Bianchini 
Simon	Eugène Simon 
Simon-Louis	Leon L. Simon-Louis 
Simpson	Charles Torrey Simpson 
Sims	John Sims 
Sinclair	Sir John Sinclair, 1st Baronet 
Singer	Rolf Singer 
Sinnott	Edmund Ware Sinnott 
Sint.	Paul Ernst Emil Sintenis 
S.Jenn.	Samuel Jennings 
S.J.Hao	Si Jun Hao 
S.J.van Leeuwen	Stephen J. van Leeuwen 
Skan	Sidney Alfred Skan 
S.K.Chen	Shu Kun Chen 
Skeels	Homer Collar Skeels 
S.Kim	Sangtae Kim 
S.K.Lee	Shu Kang Lee 
S.Knapp	Sandra Diane Knapp 
S.Koehler	Samantha Koehler 
Skottsb.	Carl Johan Fredrik Skottsberg 
Skov	Flemming Skov 
S.Kuros.	Sachiko Kurosawa 
Skutch	Alexander Skutch 
Slavin	Bernard Henry Slavin 
S.L.Clark	Stephen L. Clark 
S.Lee	Sangtae Lee 
Sleumer	Hermann Otto Sleumer 
Sloane	Hans Sloane 
Slooten	Dirk Fok van Slooten 
S.L.Welsh	Stanley Larson Welsh 
Sm.	James Edward Smith 
Small	John Kunkel Small 
Smalley	Eugene Byron Smalley 
S.M.Baker	Sarah Martha Baker 
S.McPherson	Stewart R. McPherson 
Smirnova	Zoya Nikolayevna Smirnova 
S.Moore	Spencer Le Marchant Moore 
S.M.R.Leopold	Leopold III, S. M. Roi 
Smuts	Jan Christiaan Smuts 
Smyth	Bernard Bryan Smyth 
Sneath	Peter Henry Andrews Sneath 
Snelling	Lilian Snelling 
Snyder	Leon Carleton Snyder 
Sobol.	Gregor Fedorovitch Sobolewsky 
Soderstr.	Thomas Robert Soderstrom 
Soegeng	Wertit Soegeng-Reksodihardjo 
Soepadmo	Engkik Soepadmo 
S.O.Grose	Susan Oviat Grose 
Soják	Jiří Soják 
Sol.	Daniel Solander 
Sole	William Sole 
Soler.	Hans Solereder 
Solms	Hermann Maximilian Carl Ludwig Friedrich zu Solms-Laubach 
Solomon	James C. Solomon 
Sond.	Otto Wilhelm Sonder 
Sonn.	Pierre Sonnerat 
Sonnini	Charles-Nicolas-Sigisbert Sonnini de Manoncourt 
Soó	Károly Rezső Soó von Bere 
Sopp	Olav Johan Sopp 
Soulié	Joseph Auguste Soulié 
Sowerby	James Sowerby 
Soyaux	Hermann Soyaux 
Spach	Édouard Spach 
Span.	Johan Baptist Spanoghe 
Sparrm.	Anders Sparrman 
Späth	Franz Ludwig Späth 
S.P.Churchill	Steven Paul Churchill 
S.P.Darwin	Steven P. Darwin 
Speg.	Carlos Luigi 
Spellenb.	Richard Spellenberg 
Speta	Franz Speta 
Spicer	William Webb Spicer 
S.Pierce	Simon Pierce 
Spillman	William Jasper Spillman 
Spix	Johann Baptist Ritter von Spix 
Sprague	Thomas Archibald Sprague 
Spreng.	Curt Polycarp Joachim Sprengel 
Spring	Antoine Frédéric Spring 
Spruce	Richard Spruce 
S.Q.Cai	Shao Qing Cai 
S.Q.Tong	Shao Quan Tong 
Squivet	Joseph Squivet de Carondelet 
Sreek.	Puthenpurayil Viswanathan Sreekumar 
S.R.Ramesh	S. R. Ramesh 
S.S.Chang	Siu Shih Chang 
S.S.Chien	Sung Shu Chien 
S.S.Renner	Susanne Sabine Renner 
Stace	Clive Anthony Stace 
Stackh.	John Stackhouse 
Stafleu	Frans Antonie Stafleu 
St.-Amans	Jean Florimond Boudon de Saint-Amans 
Standl.	Paul Carpenter Standley 
Stanger	William Stanger 
Stansb.	Howard Stansbury 
Stapf	Otto Stapf 
Staples	George William Staples 
Staudt	Günther Staudt 
S.T.Blake	Stanley Thatcher Blake 
Stearn	William Thomas Stearn 
Stebbing	Edward Percy Stebbing 
Stebbins	George Ledyard Stebbins 
Stebler	Friedrich Gottlieb Stebler 
Stedman	John Gabriel Stedman 
Steedman	Ellen Constance Steedman 
Steenis	Cornelis Gijsbert Gerrit Jan van Steenis 
Steentoft	Margaret Steentoft 
Steere	William Campbell Steere 
Steetz	Joachim Steetz 
Stein	Berthold Stein 
Stelfox	Arthur Wilson Stelfox 
Steller	Georg Wilhelm Steller 
Steph.	Franz Stephani 
Stephan	Christian Friedrich Stephan 
Sterba	Günther Sterba 
Sternb.	Kaspar Maria von Sternberg 
Sterns	Emerson Ellick Sterns 
Steud.	Ernst Gottlieb von Steudel 
Steven	Christian von Steven 
Steward	Albert Newton Steward 
Steyerm.	Julian Alfred Steyermark 
Stierst.	Christian Stierstorfer 
Stiles	Charles Wardell Stiles 
Still.	Benjamin Stillingfleet 
Stirt.	James Stirton 
S.T.Kim	Sang-Tae Kim 
St.-Lag.	Jean Baptiste Saint-Lager 
Stockdale	Phyllis Margaret Stockdale 
Stocker	Otto Stocker 
Stockey	Ruth A. Stockey 
Stocking	Kenneth Morgan Stocking 
Stockm.	Siegfried Stockmayer 
Stockmans	François Stockmans 
Stocks	John Ellerton Stocks 
Stockw.	William Palmer Stockwell 
Stoj.	Nikolai Andreev Stojanov 
Stokes	Jonathan S. Stokes 
Stoliczka	Ferdinand Stoliczka 
Stopes	Marie Charlotte Carmichael Stopes 
Story	Robert Story 
Strasb.	Eduard Strasburger 
S.Tripathi	Sunil Tripathi 
Stritch	L.R.Stritch 
Strobl	Gabriel Strobl 
Strutt	Jacob George Strutt 
Stuart	John Stuart, 3rd Earl of Bute 
Stuchlík	Jaroslav Stuchlík 
Stuntz	Stephen Conrad Stuntz 
Stur	Dionys Rudolf Josef Stur 
Sturm	Jacob W. Sturm 
Suckow	Georg Adolf 
Sucre	Dimitri Sucre Benjamin 
Sudre	Henri L. Sudre 
Sudw.	George Bishop Sudworth 
Suess.	Karl Suessenguth 
Suffrian	Christian Wilhelm Ludwig Eduard Suffrian 
Sukaczev	Vladimir Nikolayevich Sukachev 
Suksathan	Piyakaset Suksathan 
Suksd.	Wilhelm Nikolaus Suksdorf 
Sull.	William Starling Sullivant 
Sümbül	Hüseyin Sümbül 
Summerb.	Richard Summerbell 
Summerh.	Victor Samuel Summerhayes 
Surian	Joseph Donat Surian 
Suter	Johann Rudolf Suter 
Sutherl.	James Sutherland
Sved.	Nils 
Svenson	Henry Knute Svenson 
Svent.	Eric R. Svensson Sventenius 
S.Vidal	Sebastian Vidal 
Sw.	Olof Peter Swartz 
Swainson	William John Swainson 
Swallen	Jason Richard Swallen 
S.Waller	S. Waller 
S.W.Arnell	Sigfrid Wilhelm Arnell 
S.Watson	Sereno Watson 
Sweet	Robert Sweet 
Swezey	Goodwin Deloss Swezey 
Swingle	Walter Tennyson Swingle 
S.W.L.Jacobs	Surrey Wilfrid Laurance Jacobs 
Syd.	Hans Sydow 
S.Y.Hu	Shiu-Ying Hu 
Syme	John Thomas Irvine Boswell Syme 
Symington	Colin Fraser Symington 
Symons	Jelinger Symons 
S.Y.Sm.	Selena Y. Smith 
S.Y.Wang	Sui-Yi Wang 
S.Y.Wong	Sin Yeng Wong 
S.Zhu	Shu Zhu 
S.Z.Huang	Se Zei Huang 
Szyszył.	Ignaz von Szyszyłowicz 
T.A.Chr.	Tyge Ahrengot Christensen 
Takeda	Hisayoshi Takeda 
Takht.	Armen Takhtajan 
T.Amano	Tetsuo Amano 
Tamayo	Francisco Tamayo 
Tamiya	Hiroshi Tamiya 
Tammes	Tine 
Tamura	Michio Tamura 
Tanaka	Chōzaburō Tanaka 
T.Anderson	Thomas Anderson 
Tangav.	A. C. Tangavelou 
Tansley	Arthur Tansley 
Tärnström	Christopher Tärnström 
Tartenova	M. A. Tartenova 
Tat.	Alexander Alexejevitch Tatarinow 
Tate	Ralph Tate 
Tateoka	Tsuguo Tateoka 
Tatew.	Misao Tatewaki 
Taton	Auguste Taton 
Taub.	Paul Hermann Wilhelm Taubert 
Tausch	Ignaz Friedrich Tausch 
Tawan	Cheksum Supiah Tawan 
T.A.Williams	Thomas Albert Williams 
Taylor	Thomas Taylor 
T.Baskerv.	Thomas Baskerville 
T.Baytop.	Turhan Baytop
T.Bastard	Thomas Bastard 
T.B.Lee	Tchang Bok Lee 
T.B.Moore	Thomas Bather Moore 
T.Cao	Tong Cao 
T.C.Chen	Tê Chao Chen 
T.C.E.Fr.	Thore Christian Elias Fries 
T.Chen	T. Chen 
T.C.Huang	Tseng Chieng Huang 
T.C.Palmer	Thomas Chalkley Palmer 
T.C.Pan	Ti Chang Pan 
T.C.Scheff.	Theodore Comstock Scheffer 
T.D.Jacobsen	Terry Dale Jacobsen 
T.D.Penn.	Terence Dale Pennington 
T.Duncan	Thomas Duncan 
T.Durand	Théophile Alexis Durand 
T.E.Hunt	Trevor Edgar Hunt 
Teijsm.	Johannes Elias Teijsmann 
Temb.	Yakov Gustavovich Temberg 
Temminck	Coenraad Jacob Temminck 
Temp.	Joannes Albert Tempère 
Templeton	John Templeton 
Temu	Ruwa-Aichi Pius Cosmos Temu 
Ten.	Michele Tenore 
Ten.-Woods	Julian Edmund Tenison-Woods 
T.E.Raven	Tamra Engelhorn Raven 
T.F.Andrews	Theodore Francis Andrews 
T.F.Daniel	Thomas Franklin Daniel 
T.F.Forst.	Thomas Furley Forster 
T.G.Hartley	Thomas Gordon Hartley 
T.G.J.Rayner	Timothy Guy Johnson Rayner 
T.G.White	Theodore Greely White 
T.Hall.	Tony Hall 
T.Hanb.	Thomas Hanbury 
T.H.Chung	Tai Hyun Chung 
Thell.	Albert Thellung 
Theophr.	Theophrastus 
Thér.	Irénée Thériot 
Therese	Princess Theresa of Bavaria 
Th.Fr.	Theodor Magnus Fries 
Thiele	Friedrich Leopold Thiele 
Thieret	John William Thieret 
Thomé	Otto Wilhelm Thomé 
Thomson	Thomas Thomson 
Thonn.	Peter Thonning 
Thonner	Franz Thonner 
Thorel	Clovis Thorel 
Thorne	Robert Folger Thorne 
Thoroddsen	Þorvaldur 
Thouars	Louis-Marie Aubert du Petit-Thouars 
Thouin	André Thouin 
Threlkeld	Caleb Threlkeld 
Thuill.	Jean Louis Thuillier 
Thulin	Mats Thulin 
Thunb.	Carl Peter Thunberg 
Thur.	Gustave Adolphe Thuret 
Thurb.	George Thurber 
Thurm.	Jules Thurmann 
Thwaites	George Henry Kendrick Thwaites 
Tidestr.	Ivar Frederick Tidestrøm 
Tiegh.	Phillippe Édouard Léon van Tieghem 
Tilesius	Wilhelm Gottlieb Tilesius von Tilenau 
Tiling	Heinrich Sylvester Theodor Tiling 
Timeroy	Marc Antoine Timeroy 
Tineo	Vincenzo Tineo 
Titius	Johann Daniel Titius 
T.Itô	Tokutarô Itô 
Tjaden	William Louis Tjaden 
T.J.Chester	Thomas Jay Chester 
T.Jensen	Thomas Jensen 
T.J.Motley	Timothy J. Motley 
T.J.Sørensen	Thorvald 
T.J.Wallace	Thomas Jennings Wallace 
T.Knight	Thomas Andrew Knight 
T.Kop.	Timo Juhani Koponen 
T.Lestib.	Thémistocle Gaspard Lestiboudois 
T.L.Ming	Tien Lu Ming 
T.Lobb	Thomas Lobb 
T.MacDoug.	Thomas Baillie MacDougall 
T.Marsson	Theodor Friedrich Marsson 
T.M.Harris	Thomas Maxwell Harris 
T.Miyake	Tsutomu Miyake 
T.Moore	Thomas Moore 
T.Nees	Theodor Friedrich Ludwig Nees von Esenbeck 
T.N.McCoy	Thomas Nevil McCoy 
T.N.Nguyen	Thi Nhan Nguyen 
Tod.	Agostino Todaro 
Todzia	Carol Ann Todzia 
Toledo	Joaquim Franco de Toledo 
Tolm.	Alexandr Innokentevich Tolmatchew 
Tomm.	Muzio Giuseppe Spirito de Tommasini 
Torén	Olof Torén 
Torr.	John Torrey 
Torrend	Camille Torrend 
T.Osborn	Theodore George Bentley Osborn 
Tourlet	Ernest Henry Tourlet 
Tourn.	Joseph Pitton de Tournefort 
Touton	Karl Touton 
T.Q.Nguyen	To Quyen Nguyen 
T.R.Dudley	Theodore Robert Dudley 
Tracy	Samuel Mills Tracy 
Trad.	John Tradescant the younger 
Trail	James William Helenus Trail 
Tratt.	Leopold Trattinnick 
Traub	Hamilton Paul Traub 
Trautv.	Ernst Rudolf von Trautvetter 
Treat	Mary Lua Adelia Davis Treat 
Trécul	Auguste Trécul 
T.Reeves	Timothy Reeves 
Trel.	William Trelease 
Treub	Melchior Treub 
Trevelyan	Walter Calverley Trevelyan 
Trevir.	Ludolf Christian Treviranus 
Trevis.	Vittore Benedetto Antonio Trevisan de Saint-Léon 
Triana	José Jerónimo Triana 
Trimen	Henry Trimen 
Trin.	Carl Bernhard von Trinius 
Tristram	Henry Baker Tristram 
Troll	Wilhelm Troll 
Trotter	Alessandro Trotter 
Troupin	Georges M.D.J. Troupin 
Trumbull	James Hammond Trumbull 
Tschermak	Erich von Tschermak–Seysenegg 
Tscherm.–Seys.	Erich von Tschermak–Seysenegg 
Tscherm.–Woess	Elizabeth Tschermak–Woess 
Tsiang	Ying Tsiang 
T.S.Nayar	T.S. Nayar 
T.S.Palmer	Theodore Sherman Palmer 
T.Spratt	Thomas Abel Brimage Spratt 
T.Stephenson	Thomas Stephenson 
Tswett	Mikhail Tsvet 
T.S.Ying	Tsun Shen Ying 
T.Taylor	Thomas Taylor 
T.T.Chang	Tun Tschu Chang 
T.T.McIntosh	Terry T. McIntosh 
T.T.Yu	Tse Tsun Yu 
Tubergen	Cornelis Gerrit van Tubergen 
Tuck.	Edward Tuckerman 
Tuckey	James Hingston Tuckey 
Tul.	Louis René Tulasne 
Tullb.	Sven Axel Tullberg 
Tunmann	Otto Tunmann 
Turcz.	Nicolai Stepanovitch Turczaninow 
Turner	Dawson Turner 
Turpin	Pierre Jean François Turpin 
Turrill	William Bertram Turrill 
Tussac	François Richard de Tussac 
Tutin	Thomas Gaskell Tutin 
T.West	Tuffen West 
Twining	Elizabeth Twining 
T.W.Nelson	Thomas W. Nelson 
T.Yamaz.	Takasi Yamazaki 
Tzvelev	Nikolai Nikolaievich Tzvelev 
U.C.La	Ung Chil La 
Ucria	Bernardino da Ucria 
Udar	Ram Udar 
Ueki	Robert Ueki 
Ulbr.	Oskar Eberhard Ulbrich 
Ule	Ernst Heinrich Georg Ule 
Uline	Edwin Burton Uline 
Ulmer	Torsten Ulmer 
U.Müll.-Doblies	Ute Müller-Doblies 
Umber	Ray E. Umber 
Underw.	Lucien Marcus Underwood 
Unger	Franz Joseph Andreas Nicolaus Unger 
Unwin	William Charles Unwin 
Upham	Warren Upham 
U.P.Pratov	Uktam Pratovich Pratov 
Urb.	Ignatz Urban 
Ursch	Eugène Ursch 
U.Schneid.	Ulrike Schneider 
Usteri	Paul Usteri 
V.A.Funk	Victoria Ann Funk 
Vaga	August Vaga 
Vahl	Martin Vahl 
Vail	Anna Murray Vail 
Vaill.	Sébastien Vaillant 
Vain.	Edvard 
Valentine	David Henriques Valentine 
Valeton	Theodoric Valeton 
Valls	José Francisco Montenegro Valls 
V.A.Matthews	Victoria Ann Matthews 
Vand.	Domenico Agostino Vandelli 
Van der Byl	Paul Andries van der Bijl 
van der Werff	Henk van der Werff 
Vanhöffen	Ernst Vanhöffen 
Van Houtte	Louis Benoit Van Houtte 
Vanij.	Ongkarn Vanijajiva 
V.A.Nikitin	Vladimir Alekseevich Nikitin 
Vaniot	Eugene Vaniot 
van Jaarsv.	Ernst van Jaarsveld 
Van Scheepen	Johan Van Scheepen 
Vasey	George Vasey 
Vassilcz.	I. T. Vassilczenko 
Vatke	Wilhelm Vatke 
Vattimo	Ítalo de Vattimo 
Vaupel	Friedrich Karl Johann Vaupel 
Vavilov	Nikolai Vavilov 
V.B.Heinrich	Volker B. Heinrich 
V.Cordus	Valerius Cordus 
V.D.Matthews	Velma Dare Matthews 
Veitch	John Gould Veitch 
Veldk.	Jan Frederik Veldkamp 
Velen.	Josef Velenovský 
Vell.	José Mariano da Conceição Vellozo 
Velley	Thomas Velley 
Velloso	Joaquim Velloso de Miranda 
Vent.	Étienne Pierre Ventenat 
Verdc.	Bernard Verdcourt 
Verschaff.	Ambroise Colette Alexandre Verschaffelt 
Vesque	Julien Joseph Vesque 
V.Gibbs	Vicary Gibbs 
Vickery	Joyce Winifred Vickery 
Vict.	Conrad Kirouac, Brother Marie-Victorin 
Vida	Gábor Vida 
Vidal	António José Vidal 
Vieill.	Eugène Vieillard 
Viera y Clavijo	José de Viera y Clavijo 
Vierh.	Friedrich Karl Max Vierhapper 
Vietz	Ferdinand Bernhard Vietz 
Vig.	Louis Guillaume Alexandre Viguier 
Vignolo	Ferdinando Vignolo-Lutati 
Vilh.	Jan Vilhelm 
Vill.	Dominique Villars 
Villada	Manuel Maria Villada 
Villar	Emile Huguet del Villar 
Villarroel	Daniel Villarroel 
Villar-Seoane	Liliana Mónica Villar de Seoane 
Villaseñor	José Luis Villaseñor 
Vilm.	Pierre Louis François Lévêque de Vilmorin 
Vink	Willem Vink 
Virot	Robert Virot 
Vis.	Roberto de Visiani 
Vitman	Fulgenzio Vitman 
Vittad.	Carlo Vittadini 
Viv.	Domenico Viviani 
Viv.-Morel	Joseph Victor Viviand-Morel 
V.J.Chapm.	Valentine Jackson Chapman 
Vl.V.Nikitin	Vladimir V. Nikitin 
V.M.Badillo	Victor Manuel Badillo 
V.M.Bates	Vernon M. Bates 
Vöcht.	Hermann Vöchting 
Voeltzk.	Alfred Voeltzkow 
Vogel	Julius Rudolph Theodor Vogel 
Voigt	Joachim Otto Voigt 
Volkart	Albert Volkart 
Volkens	Georg Ludwig August Volkens 
Voss	Andreas Voss 
V.P.Castro	Vitorino Paiva Castro 
V.P.Prasad	Vadhyaruparambil Prabhakaran Prasad 
V.Prakash	Ved Prakash 
V.S.White	Violetta Susan Elizabeth White 
Vuk.	Ljudevit Farkaš Vukotinović 
Vural	Mecit Vural 
Vved.	Alexei Ivanovich Vvedensky 
V.V.Nikitin	Vasilii Vasilevich Nikitin 
W.A.Archer	William Andrew Archer 
W.A.Bell	Walter Andrew Bell 
W.A.Clark	William Andrew Clark 
W.A.Clarke	William Ambrose Clarke 
Waddell	Coslett Herbert Waddell 
Wade	Walter Wade 
Wadhwa	Brij Mohan Wadhwa 
Wad.Khan	M. A. Wadood Khan 
Wahlenb.	Göran Wahlenberg 
Waisb.	Anton Waisbecker 
Waldst.	Franz de Paula Adam von Waldstein 
Wall.	Nathaniel Wallich 
Wallace	Alfred Russel Wallace 
Wallander	Eva Wallander 
Wallays	Antoine Charles François Wallays 
Wallenwein	Fritz Wallenwein 
Wallerius	Johan Gottschalk Wallerius 
Walleyn	Ruben Walleyn 
Wallis	Gustav Wallis 
Wallman	Johan Haquin Wallman 
Walln.	Anton Wallnöfer 
Wallner	Joseph Wallner 
Wallossek	Christoph Wallossek 
Wallr.	Karl Friedrich Wilhelm Wallroth 
Wallwork	H. Wallwork 
Walp.	Wilhelm Gerhard Walpers 
Walter	Thomas Walter 
Walters	Stuart Max Walters 
W.Anderson	William Anderson 
Wangenh.	Friedrich Adam Julius von Wangenheim 
Wangerin	Walther Wangerin 
Warb.	Otto Warburg 
W.Archer	William Archer 
W.Archer bis	William Archer 
Ward	Lester Frank Ward 
Warder	John Aston Warder 
Wardle	Peter Wardle 
Warm.	Johannes Eugenius Bülow Warming 
Warner	Richard Warner 
Warnock	Barton Holland Warnock 
Warnst.	Carl Friedrich Warnstorf 
W.A.Rodrigues	William Antônio Rodrigues 
Warsz.	Józef Warszewicz Ritter von Rawicz 
Waterh.	Benjamin Waterhouse 
Watling	Roy Watling 
Watson	William Watson 
Watt	David Allan Poe Watt 
W.A.Weber	William Alfred Weber 
Wawra	Heinrich Wawra von Fernsee 
W.Bartram	William Bartram 
W.B.Clarke	Walter Bosworth Clarke 
W.C.Barton	William Charles Barton 
W.C.Cheng	Wan Chun Cheng 
W.C.Martin	William Clarence Martin 
W.Cooper	William Cooper 
W.D.Clark	W. Dennis Clark 
W.D.Francis	William Douglas Francis 
W.Dietr.	Werner Dietrich 
W.D.J.Koch	Wilhelm Daniel Joseph Koch 
Weath.	Charles Alfred Weatherby 
Weatherwax	Paul Weatherwax 
Webb	Philip Barker Webb 
Weber	Georg Heinrich Weber 
Weberb.	Augusto Weberbauer 
Wedd.	Hugh Algernon Weddell 
Wedem.	Wedemeyer 
W.E.Evans	William Edgar Evans 
Wege	Juliet Wege 
W.E.Higgins	Wesley Ervin Higgins 
Weidman	Frederick DeForest Weidman 
Weigel	Christian Ehrenfried von Weigel 
Weihe	Carl Ernst August Weihe 
Weiller	Marc Weiller 
Weim.	August Henning Weimarck 
Weinm.	Johann Anton Weinmann 
W.E.Lawr.	William Evans Lawrence 
Wells	Bertram Whittier Wells 
Welw.	Friedrich Welwitsch 
Wendelbo	Per Erland Berg Wendelbo 
Wender.	Georg Wilhelm Franz Wenderoth 
Went	Friedrich August Ferdinand Christian Went 
Werderm.	Erich Werdermann 
Wernham	Herbert Fuller Wernham 
W.E.Rogers	Walter E. Rogers 
Wesm.	Alfred Wesmael 
Wess.Boer	Jan Gerard Wessels Boer 
West	William West 
Wester	Peter Jansen Wester 
Westerd.	Johanna Westerdijk 
Weston	Richard Weston 
Wetschnig	Wolfgang Wetschnig 
Wettst.	Richard Wettstein 
Weyer	William John Bates van de Weyer 
Weyland	Hermann Gerhard Weyland 
W.F.Barker	Winsome Fanny 
W.F.Hillebr.	William Francis Hillebrand 
W.Fitzg.	William Vincent Fitzgerald 
W.G.Lee	William George Lee 
W.G.Schneid.	Wilhelm Gottlieb Schneider 
W.H.Adey	Walter H. Adey 
W.H.Baker	William Hudson Baker 
W.H.Brewer	William Henry Brewer 
W.H.Duncan	Wilbur Howard Duncan 
Wherry	Edgar Theodore Wherry 
W.H.Gibson	William Hamilton Gibson 
W.Hill	Walter Hill 
Whipple	Amiel Weeks Whipple 
Whitaker	Thomas Wallace Whitaker
Whitehouse	Eula Whitehouse 
Whitel.	Thomas Whitelegge 
Whitmore	Timothy Charles Whitmore 
Whittall	Edward Whittall 
W.H.Lang	William Henry Lang 
W.H.Lewis	Walter Hepworth Lewis 
W.H.Mills	William Hobson Mills 
W.Hook.	William Hooker 
W.Hunter	William Hunter 
W.H.Wagner	Warren Herbert Wagner 
Wibel	August Wilhelm Eberhard Christoph Wibel 
Wich.	Max Ernst Wichura 
Widder	Felix Joseph Widder 
Wiedem.	Ferdinand Johann Wiedemann 
Wied-Neuw.	Maximilian Alexander Philipp zu Wied-Neuwied 
Wiegand	Karl McKay Wiegand 
Wieland	George Reber Wieland 
Wiersema	John H. Wiersema 
Wierzb.	Piotr Pawlus 
Wigand	Julius Wilhelm Albert Wigand 
Wiggins	Ira Loren Wiggins 
Wight	Robert Wight 
Wikstr.	Johan Emanuel Wikström 
Wilcock	Christopher C. Wilcock 
Wilczek	Ernst Wilczek 
Wild	Hiram Wild 
Wilh.	Gottlieb Tobias Wilhelm 
Willd.	Carl Ludwig von Willdenow 
Wille	Johan Nordal Fischer Wille 
Williams	Samuel Williams 
Willis	John Christopher Willis 
Willk.	Heinrich Moritz Willkomm 
Wilkes	Charles Wilkes 
Wilson	William M. Wilson 
Wimm.	Christian Friedrich Heinrich Wimmer 
Windham	Michael D. Windham 
Windsor	John Windsor 
Wipff	Joseph K. Wipff 
Wirtg.	Philipp Wilhelm Wirtgen 
Wisl.	Friedrich
Wistuba	Andreas Wistuba 
With.	William Withering 
Witham	Henry Thomas Maire Silvertop Witham 
Wittm.	Ludwig Wittmack 
Wittr.	Veit Brecher Wittrock 
W.Jacobsen	Werner Bahne Georg Jacobsen 
W.J.Baker	William John Baker 
W.J.de Wilde	Willem Jan Jacobus Oswald de Wilde 
W.J.Martin	Weston Joseph Martin 
W.J.Zinger	Vasily Jakovlevich Zinger 
W.L.Clement	Wendy L. Clement 
W.L.Culb.	William Louis Culberson 
W.L.E.Schmidt	Wilhelm Ludwig Ewald Schmidt 
W.L.Wagner	Warren Lambert Wagner 
W.L.White	William Lawrence White 
W.MacGill.	William MacGillivray 
W.Martin	William Martin 
W.Mast.	William Masters 
W.M.Curtis	Winifred Mary Curtis 
W.N.Cheesman	William Norwood Cheesman 
W.N.Powell	William Nottingham Powell 
Wodehouse	Roger Philip Wodehouse 
W.O.Dietr.	Wilhelm Otto Dietrich 
Wolf	Nathanael Matthaeus von Wolf 
Wolle	Francis Wolle 
Wollenw.	Hans Wilhelm Wollenweber 
Wolley-Dod	Anthony Hurt Wolley-Dod 
Wood	William Wood 
Woodcock	Hubert Bayley Drysdale Woodcock 
Woodson	Robert Everard Woodson 
Woodv.	William Woodville 
Woodw.	Thomas Jenkinson Woodward 
Woolls	William Woolls 
Woolward	Florence Helen Woolward 
Wooton	Elmer Otis Wooton 
Wormsk.	Morten Wormskjold 
Woronow	Yury Nikolaevich Voronov 
Worsley	Arthington Worsley 
Woyn.	Heinrich Karl Woynar 
W.Palmer	William Palmer 
W.P.Armstr.	Wayne Paul Armstrong 
W.Parry	William Edward Parry 
W.P.C.Barton	William Paul Crillon Barton 
W.Peck	William Dandridge Peck 
W.Penn.	Winifred Ann Pennington 
W.Petz.	Karl Wilhelm Petzold 
W.P.Fang	Wen-Pei Fang 
W.Phillips	William Phillips 
W.Q.Zhu	Wei-Qing Zhu 
Wraber	Tone Wraber 
W.R.B.Oliv.	Walter Reginald Brook Oliver 
W.R.Buck	William Russell Buck 
W.Remy	Winfried Remy 
W.R.Ernst	Wallace Roy Ernst 
W.Rich	William Rich 
Wright	John Wright 
W.R.Linton	William Richardson Linton 
W.Saunders	William Saunders 
W.Schnizl.	Karl Friedrich Chrisoph Wilhelm Schnizlein 
W.Schultze-Motel	Wolfram Schultze-Motel 
W.S.Cooper	William Skinner Cooper 
W.Seem.	Wilhelm Eduard Gottfried Seemann 
W.Siev.	Wilhelm Sievers 
W.S.Stewart	William Sheldon Stewart 
W.Stone	Witmer Stone 
W.T.Aiton	William Townsend Aiton 
W.T.Davis	William Thompson Davis 
W.Theob.	William Theobald 
Wulfen	Franz Xaver von Wulfen 
Wullschl.	Heinrich Wullschlägel 
Wurdack	John Julius Wurdack 
Wurmb	Friedrich von Wurmb 
Württemb.	Prince Friedrich Paul Wilhelm von Württemberg 
W.Watson	William Watson 
W.Wendte	William Wendte 
W.West	William West Jr. 
W.Wettst.	Wolfgang Wettstein 
W.Wight	William Franklin Wight 
W.Wolf	Wolfgang Wolf 
W.W.Payne	Willard William Payne 
W.Wright	William Wright 
W.W.Sm.	William Wright Smith 
Wyatt-Sm.	John Wyatt-Smith 
Wydler	Heinrich Wydler 
W.Y.Hsia	Wei Ying Hsia 
W.Zimm.	Walter Max Zimmerman 
X.F.Gao	Xin Fen Gao 
X.J.Xue	Xiang Ji Xue 
Yakovlev	Gennady Pavlovic Yakovlev 
Yasuda	Atsushi Yasuda 
Yates	Lorenzo Gordin Yates 
Y.C.Wu	Yin Chan Wu 
Y.C.Yang	Yung Chang Yang 
Yen C.Yang	Yen Chin Yang 
Yeo	Peter Frederick Yeo 
Y.F.Deng	Yun Fei Deng 
Yii	P.C. Yii 
Y.N.Lee	Yong No Lee 
Ysabeau	Alexandre Victor Frédéric Ysabeau 
Y.Sasaki	Yoshiyuki Sasaki 
Y.Schouten	Y. Schouten 
Y.S.Kim	Yun Shik Kim 
Y.S.Wang	Yu Sheng Wang 
Yunck.	Truman George Yuncker 
Yu.Tanaka	Yuichiro Tanaka 
Y.Y.Fang	Yun Yi Fang 
Zabel	Hermann Zabel 
Zahlbr.	Alexander Zahlbruckner 
Zahn	Karl Hermann Zahn 
Zämelis	Aleksander Zämelis 
Zanardini	Giovanni Antonio Maria Zanardini 
Zanoni	Thomas A. Zanoni 
Zanted.	Giovanni Zantedeschi 
Zapał.	Hugo Zapałowicz 
Zappi	Daniela Cristina Zappi 
Zarrei	Mehdi Zarrei 
Zaw.	Aleksander Zawadzki 
Zaytzeva	Ekaterina S. Zaytzeva 
Z.Collins	Zacchaeus Collins 
Zea	Francisco Antonio Zea 
Zeiller	Charles René Zeiller 
Zenari	Silvia Zenari 
Zenker	Jonathan Carl Zenker 
Zenkert	Charles Anthony Zenkert 
Zeyh.	Karl Ludwig Philipp Zeyher 
Zhao	Yu Tang Zhao 
Zhebrak	Anton Romanovich Zhebrak 
Z.H.Pan	Ze Hui Pan 
Z.H.Tsi	Zhan Huo Tsi 
Z.H.Yang	Zen Hong Yang 
Ziel.	Jerzy Zielinski 
Zimm.	Philipp Wilhelm Albrecht Zimmermann 
Zinn	Johann Gottfried Zinn 
Zipp.	Alexander Zippelius 
Z.Iwats.	Zennoske Iwatsuki 
Ziz	Johann Baptist Ziz 
Zizka	Georg Zizka 
Zohary	Michael Zohary 
Zoll.	Heinrich Zollinger 
Zona	Scott Zona 
Zonn.	Ben Zonneveld 
Zopf	Friedrich 
Zorn	Johannes Zorn 
Z.Plobsh.	Friedrich August Zorn von Plobsheim 
Z.P.Wang	Zheng Ping Wang 
Zucc.	Joseph Gerhard Zuccarini 
Zuccagni	Attilio Zuccagni 
Zuloaga	Fernando Omar Zuloaga 
Zwanziger	Gustav Adolf Zwanziger 
Zycha	Herbert Zycha 